говориться: говорилось 
задача: задачи задачу 
ё: ё 
удалить: удалена 
исходник: исходниках 
ответ: ответ 
интеграция: интеграцию интеграций 
облачный: облачные 
пойти: пойдет 
изображение: изображение изображения изображений 
единица: единицы 
фраза: фраз 
давно: давно 
выбор: выбора 
яндекс: яндекс 
справка: справка 
пара: парой 
возможно: возможно 
будущее: будущем 
заниматься: занимаюсь 
режим: режиме 
смотреть: смотрим смотрю 
обмениваться: обмениваемся 
значение: значения 
комментарий: комментарии комментариях 
блок: блоке блока блоки блок 
аналогия: аналогии 
голос: голосов 
готовый: готово 
кодировка: кодировках 
меню: меню 
различный: различные 
описывать: описывает 
светло: светло 
мочь: мог можете 
дать: данная данной 
должный: должна 
понести: понесло 
тестирование: тестировании тестированию 
бот: ботов ботом бот бота 
добавить: добавить 
оба: обе 
похожий: похожих похожие 
получиться: получились получиться 
такой: такие 
нужно: нужно 
интересно: интересно 
пользователь: пользователя пользователь 
песочница: песочницы 
условие: условие условия условии 
пожалуйста: пожалуйста 
равно: равно 
получать: получаем получаю 
пообщаться: пообщаться 
знакомство: знакомства знакомство 
язык: языка язык 
схема: схема схеме схемы 
дзен: дзен 
возможность: возможность 
остановиться: остановиться остановился 
док: доки 
заголовок: заголовками заголовок 
поиск: поиск 
использовать: использовать 
придумать: придумай 
второй: втором 
карма: карма 
посчитать: посчитал 
передавать: передаем 
мой: моё 
свой: свои 
поставить: поставил 
поделиться: поделитесь 
воронка: воронок 
принцип: принцип 
генерация: генерации 
пробовать: пробую пробовать пробовал 
натыкаться: натыкался 
понимать: понимаю 
настройка: настройка настройки 
сожаление: сожалению 
перечислять: перечислять 
профиль: профиль 
быть: буду будем 
референс: референсе 
хотеть: хочет 
правильно: правильно 
ошибка: ошибки 
уровень: уровне 
нажать: нажмёт 
мессенджер: мессенджеры 
сторона: стороне 
запихать: запихать 
около: ок 
код: кода 
старый: старую 
невозможно: невозможно 
генератор: генератор 
её: её 
яп: яп 
думать: думаю 
это: это 
указать: указав указаны 
запрос: запрос запросов запроса 
работа: работу работа 
редактор: редактор 
поддержка: поддержка поддержку 
подставлять: подставляю 
старт: старте 
передать: передать 
телеграм: телеграм 
платформа: платформой 
результат: результат результаты 
текущий: текущий 
регистрация: регистрацию 
хаба: хабы 
рамка: рамках 
модель: модель модели 
рассказать: расскажу 
смысл: смысла смысл 
сгенерировать: сгенерировать сгенерированное 
скопировать: скопированный 
состояние: состояние 
функциональность: функциональность 
надоесть: надоело 
ещё: ещё 
идея: идеи 
решать: решает 
проект: проект проекта 
диалог: диалога 
отлично: отлично 
экран: экране 
чат: чат 
выдать: выдал 
тег: теги 
обработка: обработка 
привычный: привычный 
мимо: мимо 
раздел: раздел 
прочтение: прочтение 
картинка: картинки картинку 
делать: делаю делал 
корректировать: корректирует корректирую 
разный: разные разных 
статья: статье статья 
тестировать: тестирую тестируем 
отредактировать: отредактирует 
непосредственно: непосредственно 
сборка: сборкой 
запуск: запуска 
рад: рад 
начальный: начальный 
зелёный: зеленый 
ключ: ключи 
кусок: куска 
пройти: пройти 
дублировать: дублирую 
измерение: измерения 
просто: просто 
сервис: сервисы 
всё: всё 
наш: наш нашему 
ставить: ставлю 
иметься: имеется 
замечание: замечания 
версия: версию 
поболтать: поболтать 
точнее: точнее 
роман: роман 
отображаться: отображаться 
переходить: переходим перехожу 
менять: менять меняю 
интеллект: интеллект 
нейросеть: нейросеть 
мы: нам 
справиться: справился 
история: истории 
выйти: вышло 
первый: первом 
понять: понял 
одноплатформенный: одноплатформенное 
копировать: копирую 
библиотека: библиотеки библиотек 
параметр: параметры 
верный: верный 
достаточно: достаточно 
какой: какие 
вариант: варианты вариант 
хороший: лучшие 
хотеться: хотелось 
нужный: нужные 
вчера: вчера 
связывать: связываем 
создавать: создаем 
рассматривать: рассматривал 
сайт: сайт 
доступ: доступа 
мина: мин 
текст: текст 
решение: решение 
подготовка: подготовка 
нормальный: нормальный 
связанный: связанных 
работать: работает 
сутки: сутки 
конструктор: конструкторе 
разработчик: разработчик 
познакомиться: познакомился 
пощупать: пощупать 
вложение: вложении 
разместить: разместил разместим 
случиться: случилось 
вакансия: вакансии вакансий 
выше: выше 
проходимый: проходим 
мода: мод 
портировать: портируем 
примерно: примерно 
немного: немного 
искусственный: искусственный 
рейтинг: рейтинг 
изучение: изучения 
другой: другие 
далёкий: дальше 
технический: техническая 
отдавать: отдает 
внедрить: внедрит 
количество: количество 
пока: пока 
проверка: проверка 
схожий: схож 
первостепенный: первостепенная 
закладка: закладки 
пожалуй: пожалуй 
показывать: показываем 
сохранять: сохраняемые 
вернуться: вернуться 
чтожий: чтож 
себя: собой 
схитрить: схитрил 
хабра: хабр 
момент: момент 
команда: команде 
обновить: обновить 
следующий: следующей 
предыдущий: предыдущим предыдущими 
время: время 
услышать: услышать 
значит: значит 
просмотр: просмотров 
необходимость: необходимости 
публикация: публикации 
отметить: отмечу 
писать: писать 
упростить: упростит 
общий: общая 
безуспешно: безуспешно 
идти: иду 
робот: роботом 
сложный: сложнее 
описание: описание описанию 
доступный: доступная 
ссылка: ссылка 
находить: находим 
изменить: изменить 
указывать: указываю 
создание: создания 
изучать: изучаем 
действие: действиями 
тема: теме 
новый: новый 
девушка: девушкой 
убрать: убрать 
важный: важным 
