анализ: анализе анализам анализы анализ анализов 
мочь: могут 
наличие: наличием 
график: графику 
критика: критике 
распределение: распределению распределение 
структура: структура 
свой: своего свои своих 
маркер: маркеров маркера 
считаться: считается 
влиять: влияет 
наблюдать: наблюдать 
выборка: выборка выборке 
чёткий: четкие 
пользователь: пользователи пользователей 
яндекс: яндекс 
здоровье: здоровье здоровья здоровьем 
пограничный: погранично 
значение: значение значения значений значениям 
возможно: возможно 
картина: картину 
зарегистрировать: зарегистрированные зарегистрированное 
среднее: среднем среднего 
исследование: исследований исследование исследовании исследования 
разница: разницы разнице 
участвовать: участвовать 
ввести: ввели 
система: система 
знать: знаете знаю знать 
учитывать: учитывали учитываем 
канал: каналов канал канале 
комментарий: комментарии 
метаболический: метаболические 
риск: риски риск рисков риска 
голос: голосов 
дмитрий: дмитрий 
меню: меню 
видный: виден 
автор: автор 
сбор: сбору 
связанный: связанные 
иметь: имел имеют иметь имело 
часть: часть части 
конец: конце 
пересечение: пересечение 
невероятный: невероятный 
участник: участники участников 
питание: питании питание 
именно: именно 
высокий: высоким высокий высокие 
кластер: кластер кластеры 
линия: линией 
войти: войдите 
воспаление: воспалением воспаления 
добавить: добавить 
безопасный: безопасный безопасные безопасная 
превышение: превышения 
год: лет гг году года 
распределиться: распределились 
являться: являются 
видно: видно 
кто: кого кому 
будущеездоровие: будущеездоровья 
забота: заботы 
интересно: интересно 
наука: наук 
пожалуйста: пожалуйста 
справа: справа 
язык: языка язык 
который: которые 
плотность: плотности 
дзен: дзен 
аналитика: аналитика аналитикой 
попробовать: попробовал 
тренд: тренда 
женщина: женщины женщин 
первый: первые первый первым 
возраст: возраст возрасте возраста 
предложение: предложениям 
основный: основным 
отличаться: отличался 
сдавать: сдаю сдавал 
поиск: поиск 
сотня: сотен 
норма: норма нормы норме 
зож: зож 
здоровый: здоровых 
кластеризовать: кластеризовать 
отношение: отношения 
карма: карма 
реалистичный: реалистичную 
липопротеин: липопротеины 
опасный: опасное опасные 
второй: второй 
показать: показали 
превращаться: превращаются 
несколько: несколько 
проголосовать: проголосовали 
остаться: оставшиеся 
проводить: проводим 
повышенный: повышенным повышенный 
низкий: низким низкой низкие 
понимать: понимаю 
настройка: настройка 
население: населения население 
вполне: вполне 
профиль: профиль 
рост: ростом рост росте 
быть: буду будем 
показатель: показателей показатели 
зарубежье: зарубежья 
интересный: интересное интересной интересная 
маленький: меньше 
параметр: параметрам параметры параметров 
город: городах 
публика: публика 
тот: тех 
реактивный: реактивного 
повышаться: повышается 
тяготить: тяготит 
сезонный: сезонной 
образ: образ 
очный: очные 
посмотреть: посмотрел 
л: л 
черта: черта 
ссылка: ссылки ссылка 
зелёный: зеленая зеленой 
стать: стал 
старый: старую 
этот: этому 
белок: белка 
раз: раза 
красный: красная красной 
уровень: уровня уровни уровень уровнем 
род: рода 
гемоглобин: гемоглобина гемоглобин 
это: это 
зарегестрироваться: зарегестрировалось 
зона: зона 
основательно: основательно 
обстоять: обстоят 
нормальный: нормальные нормальным 
сдать: сдать 
поддержка: поддержка 
инфекция: инфекции 
заболевание: заболевания заболеванием заболеваний 
примечательно: примечательно 
жить: живем 
осознанный: осознанная 
диета: диете 
человек: людей люди человек 
результат: результат результатам результаты 
скорее: скорее 
хаба: хабы 
рамка: рамках 
триглицерид: триглицеридами триглицериды триглицеридов 
лаборатория: лаборатории 
ближний: ближнего 
предложить: предложили 
регулярно: регулярно 
базовый: базовым 
похоже: похоже 
болезнь: болезни 
процент: процентов 
выглядеть: выглядит 
бот: боте 
холестерин: холестерином холестерин холестерина 
приглашать: приглашаем 
хороший: хороший лучшие хорошем получше 
повышение: повышение повышении повышению 
интерпретация: интерпретация 
интересоваться: интересуются 
происходить: происходит 
проблема: проблем 
липидный: липидный 
проект: проект проекта 
такой: такое такая 
плохой: плохой 
выдыхать: выдыхаем 
течение: течение 
обычно: обычно 
тег: теги 
соответсвовать: соответсвует 
ниже: ниже 
прочтение: прочтение 
воспалительный: воспалительный 
неделя: недель 
особенно: особенно 
идеальный: идеален 
статья: статье 
реальный: реальную 
повлиять: повлиять 
сосудистый: сосудистая сосудистые сосудистых 
использование: использованием 
очень: очень 
наглядный: наглядной 
рад: рад 
стенка: стенках 
включать: включает 
встреча: встречи 
снижение: снижении 
третий: третий 
описать: описанные 
информация: информацией 
польза: пользу 
слева: слева 
насколько: насколько 
рф: рф 
день: день 
телеграмма: телеграмм 
небольшой: небольшие небольшого 
знак: знак 
ставить: ставлю 
назад: назад 
сам: само 
казаться: кажется 
приходиться: приходятся 
версия: версию 
зависимость: зависимостью 
лпвп: лпвп 
сосуд: сосудов сосудам сосудах 
сахар: сахар 
наш: нашей наших нашем наша 
коммерческий: коммерческий 
смотреть: смотрите 
помнить: помню 
мужчина: мужчин 
писать: писали 
кандидат: кандидат 
наблюдаться: наблюдался 
репрезентативный: репрезентативна 
превентивный: превентивной 
мы: нам нами 
связать: связать связано 
стандарт: стандартам 
история: истории 
лпнп: лпнп 
сравнение: сравнение 
принести: принесет 
средний: средний 
шесть: шесть 
комментировать: комментировать 
собрать: собрали 
воздержаться: воздержавшихся 
картинка: картинка картинку 
обработка: обработке 
процесс: процесс 
дело: дела 
высокочувствительный: высокочувствительный 
жир: жиры 
больший: большие большим 
какой: каком 
самый: самым самые 
хотеться: хотелось 
блогосфера: блогосферы 
пол: полу 
сайт: сайт 
вопрос: вопрос 
целое: целом 
накопление: накоплении 
мина: мин 
ощутимый: ощутимый 
жизнь: жизни 
кардио: кардио 
сутки: сутки 
следующий: следующему 
фактор: фактор 
сердечно: сердечно 
практический: практическая 
приходящий: приходящие 
весь: всем всей 
изменение: изменения 
краудсорсинг: краудсорсинг 
увидеть: увидели 
использовать: использованные 
январь: январе 
вклад: вкладом 
повысить: повышен 
выше: выше 
говорить: говорят 
общественный: общественной 
данные: данных 
отсекать: отсекал 
удивительный: удивительного 
примерно: примерно 
отдельный: отдельным 
точка: точке 
рейтинг: рейтинг 
технический: техническая 
общий: общий 
црб: црб 
количество: количество количеством 
выброс: выбросы 
опрос: опросе 
либо: либо 
гораздо: гораздо 
гипотеза: гипотеза 
закладка: закладки 
простой: простой 
успех: успех 
одновременный: одновременный 
конёк: конек 
вернуться: вернуться 
похожий: похожие 
клинический: клинических 
порядок: порядке 
опасно: опасно 
хабра: хабр 
таки: таки 
сложность: сложности 
сразу: сразу 
любой: любом 
видеть: видеть 
калория: калории 
час: часа 
низ: низу 
ссз: ссз 
инсулин: инсулин 
обновить: обновить 
разобраться: разобраться 
смочь: сможем 
принять: принять 
опираться: опираться 
два: две 
время: время 
простуда: простуду 
логично: логично 
активный: активной активный 
участие: участие 
значит: значит 
другой: другое другую 
хронический: хроническим 
просмотр: просмотров 
публикация: публикации 
отметить: отмечу 
телеграф: телеграф 
поделиться: поделиться 
узнать: узнать 
тема: темой теме 
научный: научной 
гликированный: гликированного 
лекция: лекций 
мг: мг 
намного: намного 
уверенный: уверен 
метаболизм: метаболизма 
оба: обоих 
никакой: никаком 
финальный: финальной 
гликировать: гликированный 
большинство: большинства 
алексеев: алексеев 
получасовой: получасовых 
рассказывать: рассказываем 
хотеть: хочу 
нарушение: нарушения 
половина: половины 
блог: блогов 
обычный: обычное 
заинтересовать: заинтересованы 
вместе: вместе 
