весь: весь всей всеми 
говориться: говорилось 
вероятность: вероятностью вероятность вероятностями 
задача: задачи задач 
модуль: модуль модулях модуля 
маска: маску маска масок маске маски маской 
свой: своего свой свои своих своем своей своими 
обучение: обучению обучения обучении обучение 
отрисовывать: отрисовывали 
большой: большой 
единственный: единственное 
являться: является являются 
смочь: смог сможете 
кол: кол 
целевой: целевого целевой 
загрузить: загрузим 
один: одного одним одной 
выбор: выбора 
яндекс: яндекс 
рисунок: рисунке рисунок 
обработка: обработки 
мой: моей моим моих моего 
подизображение: подизображение подизображениями подизображения подизображениям подизображений 
исходный: исходные исходного исходных 
автоматически: автоматически 
значение: значение значения 
оперативный: оперативной оперативную оперативная 
способный: способна 
возможно: возможно 
память: памяти память 
входной: входному входные входных 
датасет: датасет датасетов датасете датасета 
ответ: ответами 
соответственно: соответственно 
сохранить: сохраним сохранено сохранить 
структурировать: структурированным 
каждый: каждой каждому каждое каждым каждого 
представить: представлен представлено 
получать: получать получаем 
функция: функция функции функцию функций 
необходимый: необходимые необходимыми 
канал: каналов 
организовать: организовать 
надеяться: надеюсь 
размерность: размерность размерностью размерности 
комментарий: комментарии 
класс: класс классами класса классам классе классом классов классу 
возвращать: возвращать 
голос: голосов 
изображение: изображениях изображении изображения изображением изображениями изображению изображений 
готовый: готово готовую 
максимальный: максимальными 
знание: знаниями знаний 
изобразить: изображены 
меню: меню 
называть: называемых называемая 
посмотреть: посмотреть 
подгрузка: подгрузку подгрузки 
репозиторий: репозитории 
переменный: переменные переменную 
упомянуть: упомянутом 
часть: часть 
размер: размер размером размера 
другой: другим других 
котик: котика 
пиксель: пикселей пикселю пикселя пиксели 
должный: должна должно 
оказываться: оказываются оказывается 
проводиться: проводится 
потеря: потерю потерь потери 
именно: именно 
важный: важных важными важен 
часто: часто 
эксперимент: экспериментов 
джереми: джереми 
выводить: выводим выводить 
тестирование: тестировании тестирование 
вспомогательный: вспомогательные 
добавить: добавить 
присваивать: присваиваем 
цвет: цвет цвета 
метод: метода метод методом 
однако: однако 
использовать: использовали использовать используем 
число: числе 
сам: самом 
перекрытие: перекрытия 
несветаев: несветаев 
помощь: помощью 
видно: видно 
нужно: нужно 
предсказывание: предсказывания 
писать: пишем 
исследование: исследование исследовании 
выборка: выборки 
формула: формулы 
вид: виде 
семантический: семантической 
похожий: похожую похожие 
определённый: определенных определенное определенного определенный 
язык: языка язык 
получаться: получается 
который: которые которая которых который 
инициализировать: инициализировать инициализируем 
идея: идея идеи 
находиться: находится 
спутниковый: спутниковых 
дзен: дзен 
возможность: возможность 
следить: следить 
тестовый: тестовым тестовый тестовую тестовой 
перевод: перевод 
даталоадер: даталоадером даталоадера даталоадеры 
геоинформационный: геоинформационные 
результат: результатом результат результатам результаты 
наш: нашим нашей нашем 
земля: земли 
собственно: собственно 
поиск: поиск 
тот: те 
корректность: корректность 
приступить: приступим 
разбить: разбить 
прочитать: прочитав 
вес: весами веса 
сайт: сайте сайт 
точность: точность 
реализация: реализации 
код: кодом кода коду код 
карма: карма 
тип: типа типе типом 
наблюдение: наблюдениям 
работа: работы работа 
содержать: содержит 
загружать: загружаем загружать 
архитектура: архитектуры архитектурой архитектуре 
поделиться: поделитесь поделиться 
отчёт: отчет 
оптимизация: оптимизации 
второй: второй 
вычисление: вычислений вычисления 
источник: источников 
несколько: несколько 
далее: далее 
написать: написать написанную напишем 
изменяться: изменяться 
заключение: заключение 
процесс: процессе процесс 
настройка: настройка 
задействовать: задействуем 
необходимо: необходимо 
метрика: метриками метрику метрикой метрик метрикам метрика метрики 
обучить: обучили обучить 
стать: статей стала 
избежать: избежать 
удобно: удобно 
предсказание: предсказания предсказаний 
профиль: профиль 
обрабатывать: обрабатывала обрабатывать 
быть: буду будем будут 
перегружаться: перегружалась 
правильно: правильно 
количественный: количественной 
определиться: определиться определимся 
партия: партий партией партии 
колебаться: колеблющимися 
мочь: можем можете 
остаться: осталось 
развитие: развитием развитие 
начало: начала начале 
вместиться: вместиться 
представлять: представляют представлять 
сегментировать: сегментированное сегментированными сегментируемых сегментированные сегментированного сегментированных сегментированным 
рекомендация: рекомендаций 
слой: слоя слоев 
пять: пяти 
старый: старую 
недостаток: недостатки 
нейросеть: нейросетей нейросеть нейросети нейросетям 
выходной: выходные выходных выходного 
эффективный: эффективным 
генератор: генератор 
понадобиться: понадобятся понадобится понадобиться 
наличие: наличие 
длина: длина длины 
оригинальный: оригинальные оригинальных оригинальное 
графический: графического 
доступный: доступную 
это: это этим 
визуализировать: визуализируем 
разобъесть: разобъем 
брать: берем 
определить: определены определить 
начальный: начальным 
понятно: понятно 
использование: использования использовании 
перемешивать: перемешивать 
получение: получения получение 
громоздкий: громоздкие 
поддержка: поддержка 
обзор: обзор 
предобученный: предобученными предобученную 
строковый: строковыми строковым строковому строковые 
снимок: снимков 
дополнительный: дополнительной 
сохранение: сохранение сохранении 
пример: примеры 
возникнуть: возникли 
пиксел: пикселе 
хаба: хабы 
проводить: проводить проводит 
рамка: рамках 
модель: модель моделей модели моделью 
различный: различными 
директория: директориями директории директорию 
продолжать: продолжать 
определять: определяем определять 
создать: создали создать создадим 
предсказать: предсказанного 
предобрабатывать: предобрабатывать 
образ: образом 
вопрос: вопросов вопросы 
целое: целое 
туториал: туториал туториала 
пригодиться: пригодится 
обратно: обратно 
пользователь: пользователь 
хороший: хороший хорошие лучшие 
список: список списка 
организация: организация 
новичок: новичок новичкам 
показатель: показатели 
собирать: собирать 
признак: признаков 
выйти: вышел 
увеличиваться: увеличиваются увеличивается 
индекс: индексов индексом 
качество: качестве 
отлично: отлично 
разархивировать: разархивируем 
выбрать: выберем выбрал выбрать 
элемент: элемента элементов 
предсказывать: предсказывать 
слишком: слишком 
среди: среди 
возникать: возникало 
вышеописанный: вышеописанный 
обычно: обычно 
тег: теги 
представленность: представленности 
сделать: сделаем 
ниже: ниже 
вниз: вниз 
ссылка: ссылке 
уровень: уровень 
тензор: тензоров тензор тензоры 
прочтение: прочтение 
например: например 
оно: оно 
поэтому: поэтому 
особенно: особенно 
популярный: популярную 
статья: статье статья статьи 
формат: формате 
вычислять: вычислять 
иллюстрировать: иллюстрирующий 
дайса: дайса 
очень: очень 
подготовить: подготовили 
рад: рад 
включать: включает 
явно: явно 
проходиться: проходится проходимся 
удалять: удалять 
подходящий: подходящее подходящим 
сколько: сколько 
процент: процентам проценте 
перегрузить: перегруженного перегрузить 
загрузка: загрузка 
просто: просто 
переставать: перестает 
смотреть: смотря 
подход: подхода 
вышеупомянутый: вышеупомянутой 
важно: важно 
резкий: резкие 
версия: версию версии версия 
затем: затем 
хотя: хотя 
обучать: обучали обучающую обучаем обучающий обучающей 
вместо: вместо 
главный: главных 
распараллеливание: распараллеливания 
сверху: сверху 
причём: причем 
проверить: проверим 
оценка: оценки 
понять: понять 
известный: известных 
помочь: поможет помогут 
быстрый: быстрее 
указывать: указывает 
пользоваться: пользоваться пользуетесь 
дополняться: дополняться 
медиана: медианы 
также: также 
недостаточно: недостаточно 
переводить: переводить переводим 
менее: менее 
наисать: наишем 
работать: работают работает 
соответствующий: соответствующие соответствующих 
уменьшение: уменьшения 
интеллект: интеллект 
наиболее: наиболее 
этот: эта этих 
мы: нам 
процессор: процессора 
история: истории историю 
первый: первой 
запрос: запросу 
удобный: удобны 
я: мной 
обучаться: обучаться 
библиотека: библиотеки 
некоторый: некоторые 
комментировать: комментировать 
определимый: определим 
классификацировать: классификацированные 
русский: русский 
достаточно: достаточно 
создавать: создавали 
ответить: ответить 
фильтровать: фильтровать 
вывод: выводом 
какой: каком 
нужный: нужные 
преимущество: преимуществами 
импортировать: импортируем 
собачка: собачкой 
занимать: занимали 
спутник: спутника 
провести: проведем провел 
попробовать: попробовать 
параметр: параметрами параметра параметров 
оба: оба 
мина: мин 
эпоха: эпох 
такой: таким таких 
детализация: детализации 
суть: сути 
сутки: сутки 
оперировать: оперируя 
п: п 
упрощённый: упрощенную упрощенная 
соответствие: соответствии 
ширина: ширина 
разработчик: разработчик 
изменение: изменения 
коэффициент: коэффициентом 
технология: технологии 
входить: входит 
сказать: сказано 
вакансия: вакансии вакансий 
связать: связана 
выше: выше 
сравнивать: сравниваем 
высота: высота 
абстрактный: абстрактного 
запустить: запустим 
специальный: специальный 
вызов: вызову 
установить: установить 
последний: последний 
машинный: машинное 
искусственный: искусственный 
рейтинг: рейтинг 
изучение: изучения 
относить: относим 
далёкий: дальше 
сегментация: сегментации 
спектр: спектр 
технический: техническая 
больший: большим 
долгий: долгим 
отдельно: отдельно 
истинный: истинного 
количество: количество 
очищать: очищать 
словарь: словари 
указываться: указывается 
дополнительно: дополнительно 
оптимизировать: оптимизировать 
дальнейший: дальнейшего 
закладка: закладки 
простой: простой 
архив: архивы 
разделять: разделяем 
обрезать: обрезаем 
предполагать: предполагать предполагает 
уменьшаться: уменьшаются 
вернуться: вернуться 
показывать: показывает 
подробно: подробно 
хабра: хабр 
сложность: сложности 
вывести: выведем 
выступать: выступать 
жаккара: жаккара 
альтернативный: альтернативной 
обновить: обновить 
воспользоваться: воспользоваться 
протестировать: протестировали 
процентный: процентного 
два: две 
время: время 
использоваться: используется 
дать: данные 
импорт: импорты 
прогнозировать: прогнозируемым 
классифицировать: классифицированными классифицированы 
разбивать: разбивать 
корректный: корректного 
массив: массив 
присутствовать: присутствует 
значит: значит 
основа: основе 
просмотр: просмотров 
публикация: публикации 
аугментация: аугментации 
подавать: подавать 
файл: файл 
так: т 
минимальный: минимальным 
узнать: узнать 
глобально: глобально 
масивый: масива 
представляться: представляются 
описание: описание 
нагружать: нагружать 
команда: команда 
тесно: тесно 
сохранять: сохранять 
содержаться: содержится 
наоборот: наоборот 
джордан: джордан 
большинство: большинства 
разбираться: разбираетесь 
собрать: собрать 
георгий: георгий 
подгружать: подгружать 
регулировать: регулировать 
извлекатель: извлекателей 
случай: случае 
создание: создания 
отдельный: отдельная 
составлять: составлять 
вычислить: вычислить 
мара: мар 
решить: решил 
ваш: ваших 
вместе: вместе 
целый: целых 
помогать: помогают 
