мочь: могут 
заказчик: заказчиком 
труба: труб 
сечение: сечения 
вес: весом 
пространственно: пространственно 
применение: применения применением применение 
область: области область областях 
опора: опоры 
надёжность: надежность надёжность надежности 
волоконный: волоконно 
бугристый: бугристой 
друг: друга другом друг 
моноблочный: моноблочное 
технический: техническое технические техническая 
оттяжка: оттяжках оттяжек оттяжками оттяжки 
район: района районам район районах районов 
один: одного одно одной одном одна 
облегчаться: облегчается 
поскольку: поскольку 
значение: значение значения 
специальный: специальной специальными специального специальный 
гбитый: гбит 
среднее: среднем 
сила: сил 
определённый: определенным определенной определенный 
проектировать: проектируемая проектируемые 
разрешение: разрешений разрешение 
отказаться: отказаться 
атмосфера: атмосфере атмосферу атмосферы 
навык: навык 
широкий: широким шире 
уникальный: уникальные уникальны 
приёмник: приемником приёмник приемник приемника 
установить: установлена установлен установлено установить 
удобный: удобнее удобны 
период: период 
получить: полученных полученные 
преимущественно: преимущественно 
переключение: переключением 
далее: д 
срок: сроки 
экран: экранов 
радиус: радиуса 
безопасность: безопасности безопасность 
суровый: суровых 
установленный: установленным 
производитель: производители производителя 
дать: данная данной данные 
описать: описанных 
расстояние: расстояниях расстоянии расстояние 
многий: многими 
меняться: меняются 
пространственный: пространственной пространственное 
атмосферный: атмосферных атмосферно атмосферного атмосферные атмосферной атмосферная 
сообщение: сообщение 
сам: самой саму 
беспроводный: беспроводные беспроводной беспроводного беспроводных беспроводным беспроводная 
коэффициент: коэффициенты коэффициента коэффициент 
исполнение: исполнение исполнения исполнении 
вблизи: вблизи 
ход: ходе 
смена: смены 
иметь: имеют имеет имея имеющих имеющие 
случай: случаях случаев случае 
достигать: достигают достигает достигающих 
отсутствовать: отсутствует 
требовать: требует 
максимальный: максимальной максимальным 
схема: схема 
возможность: возможность возможностью 
пытаться: пытаются 
служебный: служебный служебной 
рисунок: рисунках рисунок рисунке 
возобновление: возобновление 
группа: группы 
тщательно: тщательно 
защищать: защищает 
стоимость: стоимость стоимости 
итог: итогам 
мониторинг: мониторинга 
излучение: излучению излучения 
реализация: реализации 
непроизвольный: непроизвольный 
каменный: каменных 
соединить: соединены соединено 
туман: тумана туманы туман 
работа: работы работа работу работе 
нормативный: нормативная нормативное нормативного нормативные 
управление: управления управление 
волна: волны волн 
данные: данным данных 
источник: источников источник 
несколько: несколько нескольких 
проблема: проблема проблему 
безотказный: безотказной 
оптический: оптическая оптическим оптического оптическом оптическую оптический оптических оптическое оптические оптической оптическими 
рекомендовать: рекомендуемый 
диапазон: диапазоне диапазона 
инфракрасный: инфракрасные инфракрасного 
научно: научно 
кровля: кровлю 
вполне: вполне 
перехватить: перехватить перехвачены 
линия: линия линиям линиями линий линии линию линиях 
отключение: отключение отключению 
резервирование: резервирование 
злоумышленник: злоумышленник злоумышленников 
передаваемый: передаваемой 
называться: называются 
недорогой: недорогих недорогую 
видимость: видимость видимости видимостью 
боковой: боковым 
недостаток: недостатки 
предназначить: предназначенная предназначены 
радиоканал: радиоканала радиоканалами радиоканал 
потреблять: потребляемая 
конструктивный: конструктивные конструктивных 
значительный: значительную значительной 
необходимый: необходимым необходимы необходима необходимое 
основный: основных основного 
мачта: мачта мачты мачту мачтах мачт мачтами 
пыль: пыли 
сторона: сторону стороне сторона 
попасть: попасть 
построение: построении 
корпоративный: корпоративных 
массив: массивы 
высокоэффективный: высокоэффективные 
управляемый: управляемых управляемый 
альтернатива: альтернативой 
отражённый: отраженному 
уровень: уровнях уровне уровень 
динамичность: динамичности 
сооружение: сооружения сооружений 
система: системах систем система системой системы систему 
телескопический: телескопические телескопическая телескопических 
сплошь: сплошь 
следующий: следующие 
фотодиод: фотодиод 
использование: использование использования использовании 
внутри: внутри 
поставляться: поставляться 
год: года году год 
хороший: хорошую лучшие 
пользователь: пользователь 
состояние: состояние состояния 
простой: просты простые 
пропускной: пропускную пропускной 
низкий: низкую низкие 
собирать: собирать 
выдерживать: выдерживает 
интерфейсный: интерфейсного 
представить: представила представлены 
качество: качестве качества качество 
территория: территории территорию 
свобода: свободы 
лепесток: лепесткам 
среди: среди 
принцип: принципе 
демодулироваться: демодулируется 
включить: включенном 
видеонаблюдение: видеонаблюдения 
двойной: двойного 
рыночный: рыночной 
дистанция: дистанции дистанций 
сервер: серверы 
маршрут: маршрута маршрут 
поэтому: поэтому 
лицензионный: лицензионных 
ветровый: ветровым ветровых ветровой ветровая ветрового 
сильно: сильно 
автоматический: автоматический автоматическая автоматической 
кгс: кгс 
экономичный: экономичное 
возникнуть: возникнуть 
откалибровать: откалиброванного 
отношение: отношением 
носить: носят 
снижение: снижении снижение 
пригруз: пригрузы 
несанкционированный: несанкционированного 
разный: разных разные разного 
польза: пользу 
передача: передачи передачу передача передаче 
устойчивый: устойчивы устойчивые 
механизм: механизм механизмами 
оснастить: оснащены 
сочетать: сочетает 
такой: такого таким такие таких 
треугольный: треугольного 
канал: каналами канал каналов канале каналы каналом канала 
точка: точек точка точки точке точку 
реальный: реальном реальной 
средний: средней средняя 
шифрование: шифрование шифрованию 
лазерный: лазерный лазерным 
металлический: металлические 
узкий: узкий узком узкого 
физический: физический физические физических 
характеристика: характеристик характеристики характеристика характеристикой 
здание: зданиями зданием здания зданий 
элемент: элементы элементов 
мачтовый: мачтового мачтовых мачтовые 
радиосвязной: радиосвязными 
малый: малой 
рынок: рынке рынках 
сложность: сложность 
стекло: стекло 
экономический: экономических 
посвятить: посвящена 
коммутатор: коммутаторам коммутаторы 
ведущий: ведущих ведущей 
конфиденциальность: конфиденциальностью 
практический: практическую 
считывание: считывание 
способность: способностью способность способности 
вчера: вчера 
достоинство: достоинства 
метод: методом 
электромагнитный: электромагнитного электромагнитному электромагнитных 
колонный: колонного 
комплект: комплекте комплекта 
подключиться: подключиться 
километр: километра километров 
изобразить: изображена 
монтаж: монтаж монтаже 
сутки: сутки 
подобный: подобным 
дождь: дождь дожди 
преобразовываться: преобразовывается 
интерфейс: интерфейса интерфейсов 
основать: основанная основанные основана 
гарантировать: гарантирует 
барьер: барьер 
доступность: доступностью доступность 
соответствовать: соответствует 
постоянно: постоянно 
ребро: ребра 
ствол: ствол 
регулировка: регулировка 
терминал: терминалами терминалов 
снегопад: снегопад 
пульсационный: пульсационной 
краткий: краткая 
лесной: лесные 
рейтинг: рейтинг 
составлять: составляет составляющей 
новый: новое новую новом 
предусмотреть: предусмотрен предусмотрены 
рельеф: рельефа 
карта: карты 
прить: приемо 
способ: способа способом способ 
отсутствие: отсутствие отсутствия 
токоотвод: токоотводом 
малое: малого 
доказательство: доказательства 
дополнительно: дополнительно 
довольно: довольно 
снег: снега снег 
км: км 
конечный: конечным 
вернуться: вернуться 
небольшой: небольшое 
возможный: возможных 
поле: поля полей 
себя: собой 
падать: падающей 
спутниковый: спутниковое 
проект: проекте проекта проекты 
секция: секции секций 
излучать: излучают 
позволить: позволит позволило 
обновить: обновить 
тот: той те 
вт: вт 
посредством: посредством 
использоваться: используется используются использоваться 
время: время времени 
комбинированный: комбинированный 
высота: высоте высота высотой высотами высоты высоту 
стоить: стоит 
публикация: публикации 
мфс: мфс 
соединяться: соединяется 
так: т 
луч: луч луча 
компания: компаний компаниях компании компания 
спектр: спектра спектром 
приёмный: приемно приемной приёмных 
предприятие: предприятие предприятиями 
фактор: фактором факторов факторы 
помеха: помех 
активный: активный 
подземный: подземный 
фокусировка: фокусировка 
прервать: прервана 
крыша: крышу крыше крышах 
развёртывание: развертывания 
проведение: проведения 
скорость: скорость скоростях скоростью 
полупроводниковый: полупроводниковый 
кожух: кожух 
собрать: собрать 
наветренный: наветренную 
основной: основные 
обеспечивать: обеспечивая обеспечивают обеспечивать обеспечивает 
выход: выход 
кабель: кабеля кабель 
горизонтальный: горизонтальные 
установка: установки установке установка установку 
появляться: появляться появляется 
тип: типов типа тип типы 
обратить: обращено 
вывеска: вывески 
прокладка: прокладка 
вывод: вывод 
большой: большой 
использовать: используемой используют использовать 
многоапертурный: многоапертурная 
нагрузка: нагрузкам нагрузки нагрузке нагрузка 
яндекс: яндекс 
интенсивность: интенсивности 
местность: местности 
автоматически: автоматически 
солнечный: солнечной 
ооо: ооо 
апертура: апертур 
кг: кг 
комментарий: комментарии 
голос: голосов 
непосредственный: непосредственной 
сигнал: сигнал сигнала сигналы 
маршрутизатор: маршрутизаторы маршрутизаторам 
передатчик: передатчик передатчики передатчика 
состоять: состоящие 
часть: часть частью 
ресурс: ресурс 
звуковой: звуковые 
высокий: высокая высокую высокой высоким высокий 
пульсация: пульсаций пульсации 
расчёт: расчёты расчетов расчёт расчёта расчет 
площадь: площади площадях 
щит: щит 
число: числе числа 
зависеть: зависит 
являться: являются является 
оценка: оценке 
растяжка: растяжек растяжки 
молниеприёмник: молниеприемник 
формула: формуле 
понятие: понятия 
контур: контур 
сделать: сделать сделан 
требоваться: требуется требуются 
наземный: наземной 
административный: административных 
прекращение: прекращении 
стекловолокно: стекловолокна 
зона: зоне зоны 
учитываться: учитывается учитывался 
собственно: собственно 
специально: специально 
поиск: поиск 
сумма: суммой сумма 
транспортировка: транспортировку 
свой: свои своей 
антенный: антенно 
равный: равным 
страна: странах 
сегодня: сегодня 
который: которым которых который которое которой котором которые которая 
настройка: настройка 
обнаружить: обнаружить 
место: места место месте местами местах 
следовательно: следовательно 
прочность: прочности 
радиорелейный: радиорелейные 
давление: давление давления 
отдельный: отдельный отдельных 
подключить: подключенным 
трёхкратный: трехкратное 
одновременный: одновременном одновременное 
пространство: пространства 
устройство: устройств устройствам устройства 
применять: применяя применяемых применяет применять 
считаться: считаются 
постамент: постаментах 
волс: волс 
радиоизлучение: радиоизлучения 
башня: башни башен 
значимый: значимых 
проектирование: проектировании проектированию проектирование проектирования 
рассмотреть: рассмотрены рассмотренная 
выполнить: выполненный выполнен 
обнаружение: обнаружения 
автомобильный: автомобильные 
россия: россии 
мощный: мощной 
это: это этим 
детектор: детектора 
футеровать: футерованных 
препятствовать: препятствующих препятствует 
предоставлять: предоставляя предоставляет 
величина: величину 
повышать: повышает 
входной: входной 
модель: модель моделей модели 
длина: длиной длине 
различный: различными различного различные 
плюс: плюсам плюс плюсы 
становиться: становятся 
регулярно: регулярно 
телесвязь: телесвязь 
изделие: изделия 
практика: практики практике 
стабильность: стабильность 
носитель: носители 
направить: направленная 
прямой: прямой 
лавинный: лавинный 
соединение: соединению соединение соединения 
переход: переход 
устанавливать: устанавливать 
аппарат: аппаратов 
характер: характера характер 
услуга: услуг 
применить: применена 
земля: землю земли 
средство: средства средством 
ниже: ниже 
встроить: встроенный 
первичный: первичный первичной 
прибор: приборов 
условие: условий условия условии условиях 
защитный: защитный 
метель: метель 
центр: центр 
превышать: превышающем превышает 
оператор: оператора 
статья: статья статье 
общий: общему общие 
полезный: полезного 
данный: данном данную данного данное данный 
способный: способен 
наводка: наводок 
строиться: строится 
приводить: приводит 
почва: почву 
создать: создать 
просто: просто 
основополагающий: основополагающим 
обслуживание: обслуживании обслуживания 
модельный: модельного 
степень: степенью степени степень 
снг: снг 
анализировать: анализировать 
причём: причем 
утечка: утечки 
приём: приема 
также: также 
предел: пределах 
больший: больших большие наибольшее 
изолировать: изолированный 
делать: делает 
термостабильный: термостабильный 
доукомплектование: доукомплектования 
мы: нам 
независимость: независимости независимостью 
стандарт: стандартам 
подъёмник: подъемника 
проходить: проходить проходит проходящий 
параметр: параметры параметров 
помехоустойчивость: помехоустойчивость 
достаточно: достаточно 
высокочувствительный: высокочувствительный 
внутренний: внутреннего 
порт: порту 
ярус: ярусов 
реализовать: реализована реализованные 
следовать: следует 
ухудшить: ухудшить 
действие: действиям действий 
отметить: отметить 
аэродинамический: аэродинамический 
мина: мин 
решение: решение решения решениях 
увеличение: увеличением увеличения 
радио: радио 
экранировать: экранирован 
защитить: защищенной 
вид: вида вид 
каркас: каркасом 
резервный: резервного резервным резервные резервный 
безопасный: безопасного безопасную безопасных безопасные 
расположение: расположению 
сигнализация: сигнализация 
поверхность: поверхностью поверхностях 
любой: любых любом 
оконечный: оконечных 
разнесение: разнесение 
гибридный: гибридного гибридную 
турбулентность: турбулентности 
удалённый: удаленного 
невозможный: невозможным невозможна 
информация: информации информацией информацию 
обеспечиваться: обеспечивается 
лёгкий: легкие 
промышленный: промышленной 
надёжный: надежную надежной надежным надёжных 
лазер: лазера 
два: двух 
движение: движения 
популярный: популярных популярны популярными популярное 
телеметрия: телеметрии 
частота: частот частота частоты 
обладать: обладает обладающей 
индивидуальный: индивидуальны 
остальной: остальные 
минимальный: минимальные минимальную 
отличительный: отличительные 
фермный: фермные фермных фермную фермная 
др: др 
расположить: расположить расположены 
похожий: похожие 
мрада: мрад 
радиосвязь: радиосвязи радиосвязь 
стрела: стрелы 
затрата: затраты затрат 
сразу: сразу 
момент: момент моментов 
дом: дома 
потребительский: потребительские 
световой: световой световые 
оборудование: оборудования оборудовании оборудованием оборудование оборудованиями 
отклонение: отклонение 
таблица: таблице таблица таблицы таблиц таблицах 
значимость: значимостью 
язык: язык языка 
фирменный: фирменная 
дымовой: дымовых 
рассеяние: рассеяния рассеяние 
радиочастотный: радиочастотного радиочастотных радиочастотные 
основа: основе основой 
просмотр: просмотров 
осуществляться: осуществляется 
цена: цена 
оплата: оплаты 
образец: образцы 
мало: мало 
современный: современное 
стабилизация: стабилизации 
густонаселённый: густонаселенных 
аму: аму 
вынос: вынос 
классический: классическом классических 
распространение: распространении распространения 
корреляция: корреляции 
аэроуказатель: аэроуказатели 
фундамент: фундамента 
мбитый: мбит 
метр: метров метра 
помощь: помощи помощью 
регулировать: регулировать 
плохой: плохих 
относиться: относится 
быстро: быстро 
обеспечить: обеспечить 
час: часов 
труднодоступность: труднодоступность 
широкополосный: широкополосный широкополосных 
помехоустойчивый: помехоустойчивыми 
радиоэфир: радиоэфир 
помогать: помогают 
определяться: определяется 
эксплуатация: эксплуатации эксплуатацию 
решить: решило 
внимание: внимание 
особенность: особенность особенности 
отличаться: отличаются 
прогнозировать: прогнозировать 
возможно: возможно 
объединить: объединены 
рекламный: рекламные 
ограничивать: ограничивающим 
перспективный: перспективным 
анализ: анализа анализ анализу 
подъёмный: подъемными 
крепление: крепление 
потребитель: потребителями 
меню: меню 
закрепить: закреплено 
включая: включая 
ряд: ряда 
база: базе 
транслировать: транслирующие 
важный: важных важной 
ггц: ггц 
защита: защита защиты 
повторяемость: повторяемость 
перегрев: перегрева 
угол: угле 
принимать: принимаем 
видно: видно 
излучатель: излучателем излучателей 
энергия: энергия 
что: чему 
дзен: дзен 
стена: стене стену 
фокусировать: фокусируют фокусирует 
заземление: заземления 
блок: блоком блока блок 
воздействие: воздействие воздействия 
мера: мер 
мосток: мостком 
специализировать: специализированное 
проводной: проводное проводные проводными 
верный: верном 
точность: точность точностью 
карма: карма 
объектив: объектива объективы 
рубль: рублей 
оперативно: оперативно 
диаметр: диаметра 
железобетонный: железобетонных 
чувствительный: чувствительных 
заключение: заключение 
проанализировать: проанализировав 
устанавливаться: устанавливаются устанавливается 
застилать: застилать 
привести: приведены 
необходимо: необходимо 
незаметный: незаметный 
связь: связи связь 
протокол: протокола 
участок: участки участков 
профиль: профиль 
засветка: засветки 
зависимость: зависимости 
обращать: обращать 
программный: программное 
препятствие: препятствий препятствиями препятствия 
согласно: согласно 
л: л 
б: б 
сетевой: сетевых сетевым 
факт: фактов факт 
сеть: сети сетей сетям 
значительно: значительно 
собственный: собственных собственную 
преобразование: преобразования 
коммутация: коммутации 
технология: технология технологией технологии технологий 
составной: составные составная 
наличие: наличие наличии 
свет: света 
закрепление: закрепления 
тыс: тыс 
аолс: аолс 
передавать: передающий передающего передающих передавать передающее 
горячий: горячим 
отобразить: отображены 
существовать: существуют существует 
поддержка: поддержка 
приемлемый: приемлемой 
пример: примеры примере 
электрический: электрический 
расхождение: расхождения 
пейджинга: пейджинг 
наведение: наведения 
позволять: позволяет позволяющий позволяющие 
отечественный: отечественного 
разбираться: разбирается 
радиопомеха: радиопомехам 
профессиональный: профессиональная 
рабочий: рабочих 
сильный: сильный сильной сильного 
кквить: ккви 
выглядеть: выглядит 
радиолокатор: радиолокаторы 
рассматривать: рассматриваемом 
обратно: обратно 
рамка: рамки 
приёмопередающий: приемопередающих приемопередающие 
болт: болтами 
происходить: происходит 
постройка: постройке 
покрыть: покрытые 
модуль: модули модуль модуля 
перехват: перехвата перехват 
погодный: погодные погодных 
вероятность: вероятность 
перенести: перенести 
тег: теги 
заглубить: заглубленного 
попадание: попадания 
какой: каких 
постараться: постараться 
подключение: подключение 
м: м 
мощность: мощность мощности 
легко: легко 
ускорить: ускорило 
наблюдаться: наблюдается 
форма: форму 
очень: очень 
пучок: пучка 
развернуть: развернуть 
разработать: разработаны разработана 
стоящий: стоящими 
оказывать: оказывают 
вакуум: вакуум 
исходить: исходя 
настоящий: настоящее 
мф: мф 
лицензирование: лицензирования 
близость: близости 
применяться: применяется применяются 
сверху: сверху 
обнаружиться: обнаружилось 
известный: известных 
принтер: принтеры 
радиодоступ: радиодоступа радиодоступ 
менее: менее 
противостояние: противостояние 
наш: нашем 
направление: направлениях 
наиболее: наиболее 
радиооборудование: радиооборудования 
модулировать: модулированные 
непрерывный: непрерывная 
стальной: стальных стальная стальные стальным 
показать: показал 
практически: практически 
ввод: ввода 
любительский: любительская 
анкерный: анкерной 
однонаправить: однонаправленный 
графический: графические 
избыточный: избыточного 
проливный: проливной 
сайт: сайт 
целое: целом 
доступ: доступа доступ 
собираться: собираются 
коррозия: коррозии 
характерный: характерную 
персонал: персонала 
груз: груза 
камера: камеры 
высокозащищённый: высокозащищенных 
подверженный: подверженные подвержен 
давать: дает дают 
особенный: особенной 
регулировочный: регулировочного 
совместимый: совместимы 
выходить: выходит 
угловой: углового 
частица: частиц 
весь: всем вся 
результат: результаты 
выше: выше 
расходимость: расходимостью 
типичный: типичная 
последний: последней 
организация: организациями организации 
немного: немного 
производить: производит 
транкинг: транкингом 
прогрессивный: прогрессивной 
количество: количество 
код: кодами 
ветер: ветра 
равномерно: равномерно 
быстрый: быстрые быстрого 
либо: либо 
увеличивать: увеличивают увеличивает 
проверяться: проверяется 
закладка: закладки 
возникновение: возникновения 
показывать: показывает 
многие: многие 
городской: городские 
название: название 
изготавливаться: изготавливаются 
определять: определять определяющий 
деталь: деталей 
сведение: сведения 
сказываться: сказываются 
густой: густой 
никакой: никаких 
диод: диод 
устойчивость: устойчивость 
выходной: выходного 
прогресс: прогресс 
объект: объектами объектов 
технологический: технологический 
отличие: отличие 
высоконадёжный: высоконадежных 
быть: будут 
производство: производству производства 
колебание: колебаний 
оба: обоих 
географический: географического 
ленинградский: ленинградской 
дополнительный: дополнительного 
счёт: счет 
случайный: случайные 
метеорология: метеорология 
находиться: находясь находятся находится 
самый: самые 
блог: блог 
известно: известно 
согласование: согласований 
цинкование: цинкованием 
безлицензионный: безлицензионной 
коллимировать: коллимированный 
корпус: корпус 
минус: минусы 
ввиду: ввиду 
управлять: управляет 
несложный: несложная 
образование: образованию 
фермной: фермной 
миля: мили 
вестись: ведётся 
решетчатый: решетчатые 
калибровать: калиброванным 
служить: служить 
представлять: представляет 
разрыв: разрыва 
обеспечение: обеспечение 
вдоль: вдоль 
целесообразно: целесообразно 
ухудшение: ухудшение 
увеличить: увеличить 
должный: должна 
предотвращение: предотвращения 
оптоволокно: оптоволокна 
железнодорожный: железнодорожные 
добавить: добавить 
учитывать: учитывающий 
лестница: лестницу 
нужно: нужно 
достигаться: достигается 
спуск: спуска 
экспериментальный: экспериментальные 
прерывать: прерывать 
молниеотвод: молниеотводов 
дальность: дальность 
самостоятельный: самостоятельный самостоятельная 
трафик: трафика 
возводиться: возводится 
прерывание: прерывание 
присущий: присущей 
телеуправление: телеуправления 
сезон: сезона 
путь: пути 
зрение: зрения 
смотреть: см 
вершина: вершине 
создавать: создают создает 
селекция: селекции 
гц: гц 
цель: целью 
приложение: приложений 
переносить: переносит 
радиотехнический: радиотехнические 
образоваться: образовавшееся 
серия: серии 
согласовательный: согласовательных 
конструкция: конструкции конструкцию конструкций конструкция 
проверять: проверять 
подвергаться: подвергается 
делиться: делятся 
старый: старую 
динамический: динамическим 
раз: раза 
обмен: обмен 
увидеть: увидеть 
свободно: свободно 
комплектация: комплектации комплектация 
отправляться: отправляется 
нарушитель: нарушителю 
каждый: каждое каждый 
произвести: произведен 
учесть: учтена 
пр: пр 
учёт: учётом 
техника: техники 
хаба: хабы 
разобрать: разобрать 
нордверк: нордверк 
распределение: распределения 
отслеживание: отслеживание 
образ: образом 
покрытие: покрытия 
денежный: денежные 
работать: работающие 
участие: участия 
положение: положение 
обновляться: обновляются 
достигнуть: достичь 
обычно: обычно 
преодолеть: преодолеть 
прочтение: прочтение 
обслуживать: обслуживать 
временной: временной 
результирующий: результирующего 
подъём: подъема 
благодаря: благодаря 
передаваться: передается 
утренний: утреннее 
прохождение: прохождению 
новизна: новизны 
базовый: базовая 
упростить: упростило 
эффект: эффекты 
кроме: кроме 
рф: рф 
указать: указать 
питание: питания 
важно: важно 
определённо: определенно 
приходиться: приходятся 
затем: затем 
версия: версию 
сравнение: сравнению 
востребовать: востребована 
доступный: доступных 
явление: явления 
модулирование: модулирование 
вмешательство: вмешательства 
предельный: предельное 
создание: создание 
выбор: выбор 
защищённость: защищенности 
работоспособность: работоспособность 
сохранение: сохранении 
наращивание: наращивания 
помещение: помещений 
п: п 
эфирный: эфирное 
определение: определения 
день: дней 
ограждать: ограждающих 
объём: объем 
выгодный: выгодны 
говорить: говорят 
поглощение: поглощение 
приёмопередатчик: приемопередатчиков приемопередатчики 
влиять: влияют 
металлоконструкция: металлоконструкцию 
сниматься: снимается 
нацелить: нацелены 
проектный: проектных 
украсть: украсть 
распорка: распорки 
другой: другие другому 
ощутимо: ощутимо 
невидимость: невидимость 
конкретный: конкретные 
настолько: настолько 
иной: иной 
телевещание: телевещание 
изменение: изменение 
оснащать: оснащают 
стандартный: стандартные 
окружающий: окружающих 
текстовый: текстовые 
климат: климат 
молния: молний 
хабра: хабр 
универсальный: универсальный 
местоположение: местоположения 
настраиваться: настраиваются 
приниматься: принимается 
удовлетворительно: удовлетворительно 
провести: проведя 
изменчивость: изменчивостью 
телестанция: телестанции 
гарантия: гарантию 
потеря: потери 
водонапорный: водонапорные 
ограничение: ограничения 
станок: станка 
сказать: сказать 
трудно: трудно 
попытка: попытке 
влияние: влияние 
выбрать: выбрано 
телекоммуникационный: телекоммуникационных 
производиться: производится 
потенциал: потенциалом 
