материал: материалов материале 
конвертировать: конвертировать 
утилит: утилиту утилиты утилит утилите 
ваш: ваш ваше вашего вашему 
версия: версиях версий версию 
вход: входе входа вход 
обычный: обычными 
приложение: приложения приложение приложений 
максименко: максименко 
метафора: метафора 
простой: простых простой 
настройка: настроек настройка 
стаж: стажем 
ответ: ответ 
поддерживать: поддерживать 
разбавить: разбавить 
контроль: контроль 
являться: является 
напоследок: напоследок 
выдохнуть: выдохнем 
действие: действия 
сущность: сущность сущности 
подхватывать: подхватывает 
один: одного одном 
всяческий: всяческие 
яндекс: яндекс 
пара: парой паре 
пойти: пойти 
манифест: манифестов манифестами манифест манифеста манифесты манифесте 
возможно: возможно 
успешно: успешно 
подходить: подходит подходили 
наш: наше 
очевидный: очевидный очевидны 
запрос: запросами запрос 
комментарий: комментарии 
приготовиться: приготовьтесь 
голос: голосов 
раз: разу 
инженер: инженеры инженер инженеров 
какой: какого 
передавать: передает передавая 
позиционировать: позиционирует 
подготавливать: подготавливают подготавливать 
способ: способам способ способы способов 
меню: меню 
твой: твой 
деплоить: деплоить деплоит деплоите деплоя деплою 
прогнать: прогнать 
репозиторий: репозитории 
переменный: переменные переменных 
громко: громко 
глаз: глаза 
одинаковый: одинаковых 
любой: любое любой 
ресурс: ресурс 
безопасность: безопасности безопасность 
рядом: рядом 
дать: данная данной дадут данные 
пайплайна: пайплайны пайплайн 
именно: именно 
часто: часто 
базовый: базовый базовыми 
начать: начать 
существенно: существенно 
нечто: нечто 
комьюнити: комьюнити 
дело: деле 
немаловажный: немаловажную 
означать: означало 
низкий: низкий 
свой: свой 
реализовать: реализуют 
контейнерный: контейнерных 
начинать: начинает 
добавить: добавить 
удивиться: удивлюсь 
сам: самом 
помощь: помощью 
такой: такие такого таким таких 
нужно: нужно 
параметризация: параметризации 
оператор: операторами оператор 
пожалуйста: пожалуйста 
ранний: раньше 
поговорить: поговорим 
подход: подход подходов подхода подходом 
язык: языка языки язык 
который: которые которых который котором 
требовать: требует 
дзен: дзен 
гласить: гласит 
пайплайн: пайплайнов 
статья: статью статье статьи 
итог: итоге 
автоматизация: автоматизацию 
прямо: прямо 
делать: делают делает делал делайте 
карьера: карьеру 
секрет: секретов 
основный: основным основного 
соединяться: соединяются 
поиск: поиск 
зрение: зрения 
использовать: использовать используют использует используя 
существовать: существует существуют 
лишь: лишь 
однозначно: однозначно 
неожиданно: неожиданно 
параметризированный: параметризированна 
реализация: реализации 
карма: карма 
клиент: клиент 
взгляд: взгляд взгляда 
мера: мере 
превращать: превращает 
оперировать: оперирует 
рендёр: рендер 
генерация: генерации генерация 
вдыхать: вдыхал 
скриптовый: скриптовый скриптовые 
далее: далее 
написать: написать написанные 
становиться: становитесь 
единственный: единственным единственная 
специальный: специальные 
нравиться: нравится 
оправдать: оправдано 
сегодня: сегодня 
плагин: плагины 
десятка: десятки 
честной: честному 
возникать: возникает 
рука: руками 
необходимо: необходимо 
мощный: мощная мощный 
удобно: удобно 
вполне: вполне 
профиль: профиль 
человек: людям люди 
прочий: прочих прочем 
зависимость: зависимости 
рост: ростом 
хотеть: хочет хотели хотите 
бояться: боюсь 
следовать: следуя 
мешать: мешает 
далеко: далеко 
тот: тех 
неправильно: неправильно 
смотреть: смотреть 
показаться: показаться 
называться: называются 
блистать: блистал 
образ: образ образом 
статический: статический статическими статические 
самый: самый самая 
задача: задач 
играть: играет 
код: кода коде 
стать: стал стало 
получать: получаете 
старый: старую 
программирование: программирования 
этот: этому эта 
вперёд: вперёд 
увеличиваться: увеличиваться 
сторона: сторона 
незамысловатый: незамысловатый 
название: названием 
увидеть: увидеть 
малый: меньшей 
знать: знаю знает 
ходить: ходить 
рабочий: рабочий 
директория: директорий директория директории 
писать: пишут писать 
демонстрация: демонстрации 
интерпретатор: интерпретатора 
подготовка: подготовки 
это: это этим 
иметь: имеет 
использование: использования использование использовании 
команда: команды 
поддержка: поддержка поддержку 
лещ: леща 
странный: странных 
кастомайзер: кастомайзер 
видеть: видел видите 
скорее: скорее 
повышать: повышает 
шаблонизатор: шаблонизатором шаблонизатор шаблонизатора 
тема: тема 
позволять: позволяет 
хаба: хабы 
приходиться: приходилось 
задеплоить: задеплоить 
мудрость: мудрость 
создавать: создавать 
взять: взять 
сгенерировать: сгенерировать 
внутри: внутри 
общий: общими 
сильный: сильная 
запредельный: запредельный 
инкубатор: инкубаторе 
стабильность: стабильность 
финальный: финальный 
хороший: хорошую лучшие 
пользователь: пользователь 
состояние: состояние 
практика: практике 
ещё: ещё 
стабильный: стабильнее 
разрабатывать: разрабатываете 
неоспоримый: неоспоримые 
происходить: происходит 
нужный: нужна нужные 
основа: основа 
личный: личный 
качество: качестве 
девопёс: девопсу 
народный: народная 
менеджер: менеджером 
провернуть: провернуть 
среди: среди 
принцип: принципе 
говорить: говорили 
подать: поданный 
тег: теги 
сделать: сделаем 
известный: известная 
деплый: деплой 
средство: средства 
совет: совет 
ниже: ниже 
продукт: продукт 
вернуться: вернемся вернуться 
уровень: уровень 
указать: укажите 
встроить: встроенный встроен 
внутренний: внутренней 
прочтение: прочтение 
плечо: плечу 
огромный: огромное 
например: например 
добавление: добавлению 
алексей: алексей 
скажем: скажем 
легко: легко 
первый: первый первым 
обойти: обойду 
слово: словами 
мнение: мнение 
очень: очень 
лирический: лирическое 
понять: поймите 
раскладывать: раскладываем 
сложный: сложным 
дыхание: дыхании 
ты: тебе 
обход: обход 
плюс: плюсы плюсов 
кроме: кроме 
данный: данном данного данный 
операционный: операционных 
логика: логики логику 
часть: частью 
верный: вернее 
передача: передачи 
роль: роль 
подчас: подчас 
день: день 
пятница: пятницу 
параметризатор: параметризатор 
продуктовый: продуктовые 
исходить: исходя 
распространить: распространенный 
архив: архив 
спросить: спросите 
инфраструктурный: инфраструктурном 
просто: просто 
парадигма: парадигме 
мерджил: мерджил 
запаковать: запаковать 
важно: важно 
всё: всё 
абсолютно: абсолютно 
вместо: вместо 
начинаться: начинается 
правило: правилам правил 
кусок: куски 
использоваться: используются 
недолгий: недолгую 
шаблонизация: шаблонизация 
идти: идем 
инструмент: инструмента инструментом инструменты инструмент 
пользоваться: пользуется пользоваться 
прочитать: прочитают 
закладывать: закладывать 
подготовить: подготовленные 
мутация: мутации 
скормить: скормить 
готовить: готовим 
история: истории 
большинство: большинство 
оставаться: остается 
комментировать: комментировать 
параметр: параметры параметров 
учебный: учебных 
документация: документацию 
точка: точки 
перспективный: перспективные 
достаточно: достаточно 
процесс: процесс 
пакетный: пакетным 
взрослый: взрослым 
кластер: кластере кластера 
истина: истине 
хотеться: хотелось 
вчера: вчера 
отступление: отступление 
кусочек: кусочками кусочки 
вопрос: вопрос 
организация: организации 
мой: мою 
отправлять: отправляете 
кастомизировать: кастомизированных 
чарт: чарты чартов 
мина: мин 
он: нём 
давать: давайте 
счастие: счастье 
работать: работает работать работало 
суть: сути 
сутки: сутки 
вид: вида 
реализоваться: реализуется 
проект: проекта проекте 
современный: современный 
большой: большое 
забегать: забегая 
библиотека: библиотек 
коробка: коробки 
статика: статика 
нарочно: нарочно 
мир: мир 
вакансия: вакансии вакансий 
разработчик: разработчиков 
быть: будем 
выгореть: выгоревшему 
постоянно: постоянно 
выход: выходе 
вещь: вещи 
функционал: функционалом функционала 
последний: последний последних 
строчка: строчка 
производить: производит 
информация: информации 
рейтинг: рейтинг 
любить: любят 
далёкий: дальше 
подставить: подставив 
технический: техническая 
весь: всеми 
настолько: настолько 
отдельно: отдельно 
количество: количество количеством 
полный: полный 
гибкий: гибким 
дядя: дядям 
рассчитывать: рассчитываю 
чёкаяться: чёкаясь 
понимание: понимания 
разнообразный: разнообразен 
довольно: довольно 
порт: порта 
буквально: буквально 
стоя: стоя 
закладка: закладки 
пожалуй: пожалуй 
грустный: грустном 
дружить: дружат 
похожий: похожие 
состоять: состоящее 
каталог: каталогам 
себя: собой 
отцовски: отцовски 
подавлять: подавляющее 
хабра: хабр 
работа: работа 
сложность: сложности 
сразу: сразу 
главное: главное 
переиспользоваться: переиспользуются 
дистрибутив: дистрибутив 
представимый: представим 
обновить: обновить 
сегодняшний: сегодняшний 
смочь: сможем 
определять: определять 
два: две 
минимум: минимум 
время: время 
называть: называет 
заранее: заранее 
другой: другое 
стоить: стоит 
просмотр: просмотров 
публикация: публикации 
пить: пьют 
вечером: вечером 
минимальный: минимальным 
набор: набор 
звучать: звучит 
мало: мало 
получить: получите 
сумасшедший: сумасшедший 
хлопать: хлопали 
контейнер: контейнера 
номер: номер 
подойти: подойдете 
казаться: казалось 
сказать: сказать 
необычный: необычных 
утилита: утилита 
каждый: каждая 
порог: порог 
пример: пример 
описать: описать 
конфигурация: конфигурации 
стоять: стоят 
система: систем 
мочь: можете 
к: ко 
минус: минусы 
