населить: населён 
весь: весь 
адрес: адресов адреса адресу адресам адрес 
мочь: могут можем могли можете 
повторить: повторить 
обозначаться: обозначаются 
хлопоты: хлопот 
игра: игры игре игрой игру игра игр 
рисоваться: рисуется 
вызываться: вызывается 
эмулировать: эмулируемого эмулировать эмулируемый 
содержать: содержали содержат 
включать: включающая 
позволить: позволило позволит 
вывод: вывод 
клавиша: клавишах клавиш клавиша клавишу клавиши 
миллисекунда: миллисекунды 
просмотр: просмотре просмотров 
плавный: плавным плавнее плавного плавный 
понять: поняли 
время: времена временем время временам 
область: области область 
являться: является 
мигать: мигающую мигающий мигать 
клетка: клетки клеткой клеток клетке клетками клеткам клетку 
байт: байтов байтам байты байт байтами байта байту 
изображение: изображение 
наблюдать: наблюдать 
счётчик: счётчиком счётчика счётчики счётчиков 
друг: друга друг 
старое: старого 
адресация: адресация 
игровой: игровые игровому игрового 
отладчик: отладчик отладчике 
знаменитый: знаменитый 
цветовой: цветовых 
капризный: капризным 
база: базы базе 
один: одного одна одному одной 
пользователь: пользователи пользователь 
правый: правого правый 
вариант: варианте вариант 
особенность: особенность особенностью 
яндекс: яндекс 
поскольку: поскольку 
заглавный: заглавные 
добиться: добиться 
отображаться: отображаются 
динамический: динамического 
автоматически: автоматически 
малый: малая 
возможно: возможно 
память: памяти память памятью 
режим: режиме 
медленно: медленно 
консоль: консоли 
указывать: указывать указывают указывает указывающий 
враг: враги врагами врагов 
подходить: подходит 
сам: самого самом самим самой 
наш: наше 
шаг: шагом шаг шаге 
классика: классика 
воспринимать: воспринимать 
иной: иными 
анализ: анализа анализу анализ 
попадать: попадает 
видеоадрес: видеоадрес видеоадреса 
очевидный: очевидный 
значение: значения значений значением 
разрешение: разрешением разрешения 
строка: строка строке строкам строки строку строк 
представление: представления представление 
вычисление: вычисление вычислений вычислением вычисления 
считыватель: считывателя 
терпеливо: терпеливо 
блок: блоке блоком блоками блока блокам блоков блоки блок 
видный: видна 
комментарий: комментарии 
подробность: подробности 
раз: разу раза 
овский: овского 
голос: голосов 
перейти: перейти 
состояние: состояния 
оказаться: оказавшись оказалось 
хотеть: хотел хочет хотим хотите 
случай: случай случаев случае 
тон: тона тон 
понажимать: понажимать 
пересчёт: пересчёту 
строчка: строчками 
персонаж: персонаж 
нижний: нижняя нижнем нижние 
меню: меню 
должный: должны 
тот: тому те тех той 
выносить: выносить 
считываться: считываются 
помимо: помимо 
патч: патч 
выделять: выделяю 
включая: включая 
идти: идёт идти 
старший: старших старшие старший 
задача: задача 
видеопамять: видеопамяти видеопамять 
регистр: регистре регистра регистрах регистры регистр регистрами 
отрисовать: отрисованный отрисованы отрисовать 
четверть: четверть 
часть: часть частям частью части 
терпимый: терпимым 
указатель: указатель 
размер: размер размером 
конец: конце 
левый: левый левее 
продвижение: продвижении 
пиксель: пикселей пиксель 
увеличить: увеличить увеличит увеличенное 
оставить: оставил 
ассемблерный: ассемблерного 
инкрементировать: инкрементировать 
пройтись: пройдёмся 
устройство: устройстве 
видеовывод: видеовывод 
часто: часто 
экономить: экономить 
прорисовывать: прорисовывает 
ожидать: ожидая 
неоптимальный: неоптимально 
загружаться: загружается загружалась 
ячейка: ячеек ячейка ячейкой ячейку ячейки 
заодно: заодно 
уточнение: уточнение 
попасть: попадём 
файл: файлах файлов файлами файлы файл 
хардкорный: хардкорный 
продумать: продумать 
свой: свой 
маленький: поменьше 
последовательно: последовательно 
храниться: хранятся хранящимися хранился хранится 
перестать: перестали 
начинать: начинает 
добавить: добавить 
цвет: цвет цветов цвета 
начало: начало начале 
образ: образе образом образов образы 
наложение: наложение наложения 
кавычка: кавычки 
ваш: вашим вашем 
делаться: делается 
белый: белой белом 
однако: однако 
причём: причём 
хранить: хранит хранить хранящий 
перенос: перенос 
частый: чаще 
прирост: прирост 
такой: такие такую такое такого такая 
столбец: столбца 
нужно: нужно 
переписывание: переписывание 
интересно: интересно 
понимать: понимают понимать 
песочница: песочницы 
анимировать: анимированной 
битый: бит бита 
грубый: грубая грубой 
итого: итого 
справа: справа 
граница: границы 
получать: получаем 
окрасить: окрашен 
простой: проще простым 
вносить: вносить 
настройка: настройках настройка 
сделать: сделать 
подход: подход подхода подходы 
сдвигать: сдвигать сдвигают 
язык: языка язык 
набрать: набрать набрав 
чистый: чистый 
который: которые которым которой которая которых который которую которому котором 
получаться: получается 
развёртка: развёртку 
требоваться: требуется 
хранение: хранения хранение 
требовать: требует 
течение: течении 
находиться: находится 
дзен: дзен 
петля: петель 
мысль: мысли 
реализация: реализация 
возможность: возможность 
какой: какую каким 
каждый: каждому каждые каждый каждая 
автор: авторы 
внешний: внешнего внешний внешних 
эмулятор: эмуляторы эмуляторе эмулятору эмуляторов эмулятор эмулятора эмуляторах 
временной: временного 
однобайтовый: однобайтовые 
группа: группы группу группе группа 
экран: экрану экране экран экрана 
стек: стеке стека стек 
проверить: проверить проверьте 
компьютер: компьютер компьютере компьютера 
нажатие: нажатии нажатия 
увеличивать: увеличивая 
приходить: приходят 
привидение: привидения привидению 
расположить: расположены расположенного расположенная расположенные расположена расположенный 
набирать: набирать 
полагаться: полагаться 
буква: буквы буква 
рисовать: рисуя рисует 
поиск: поиск 
сложить: сложив 
видимый: видимой видимую видимый видимого 
использовать: использовать используя 
кнопка: кнопок кнопки кнопку 
изменение: изменениям изменения изменение 
монохромный: монохромной 
попробовать: попробуйте попробовать попробуем 
существовать: существует существуют 
бордюр: бордюре бордюра бордюр 
неожиданно: неожиданно 
лишь: лишь 
включение: включения 
доллар: доллара 
компактный: компактные компактной компактным компактная 
использоваться: использовались используется 
тактовый: тактов 
код: кодом кода коду код 
избегать: избегать 
карма: карма 
стековый: стековые 
страшный: страшные 
ускорить: ускорить 
потребовать: потребуют 
ассемблер: ассемблере 
движение: движении движение движения 
работа: работы работа работе 
простота: простота 
результат: результате 
многое: многое 
операционный: операционной 
ждать: ждать 
клавиатура: клавиатуру клавиатура клавиатуре клавиатуры 
совершенно: совершенно 
оптимизация: оптимизации оптимизациях оптимизаций оптимизация 
выполнять: выполняет выполнять 
запустить: запустил 
начинаться: начинаются начиналась 
второй: второй вторых вторую 
надпись: надпись 
несколько: несколько нескольких 
место: месте места место 
спектрум: спектруме спектрумы 
сигнал: сигнала 
увеличение: увеличение 
называть: называть 
чёрно: чёрно 
далее: далее 
написать: написать написанных 
поменять: поменять 
следующий: следующую следующие следующим следующий следующей 
нравиться: нравится нравятся 
скачать: скачать 
готовый: готовой готов 
подстройка: подстройки 
наивный: наивный 
два: двумя двум две 
нажать: нажмёте нажав нажать 
отображать: отображает 
ключевой: ключевые ключевое 
разобраться: разобрались 
загрузка: загрузку загрузка 
старый: старой старую старый старом старые 
измениться: изменится 
вполне: вполне 
расширение: расширениями расширения 
вызов: вызова 
профиль: профиль 
программа: программу программа программы 
оператор: операторы оператора операторов оператору 
пауза: паузы 
портиться: портятся 
уметь: умеют 
понятный: понятным понятный 
цикл: циклах цикла цикл цикле циклов 
равный: равна 
далеко: далеко 
заменить: заменив 
спектрумист: спектрумисты 
плохо: плохо 
означать: означает 
альтернативный: альтернативном 
присмотреться: присмотреться 
внутренний: внутренний внутреннем внутреннего 
кассета: кассета 
уровень: уровне уровни уровнях уровень 
номер: номера номер 
любить: люблю 
проход: проходов проходе 
снапшота: снапшоты снапшот 
самый: самый самым самая самое самые 
поиграть: поиграл поиграть 
технический: технические техническая 
вводиться: вводятся 
крупный: крупная 
желание: желание 
стать: стал станет 
дискета: дискеты дискета 
лента: ленты ленте 
сдвиг: сдвига 
инкрементироваться: инкрементируются инкрементируется 
графика: графика графики 
процессор: процессоре процессора процессор 
выработать: выработали 
битов: битов 
её: её 
увидеть: увидеть увидим 
наличие: наличие 
подумать: подумать подумал 
задействовать: задействован 
ёжик: ёжики ёжикам ёжик 
возвращаться: возвращаясь 
лабиринт: лабиринте лабиринта лабиринт 
вычислить: вычислит 
опубликовать: опубликовать 
спектрумовский: спектрумовской спектрумовский 
писать: пишут писали пишет 
пустой: пустой пустые пустых 
это: это этим 
применить: применить 
знание: знание 
центральный: центральной 
однопиксельный: однопиксельной 
сторона: сторону 
иметь: имеет 
машина: машине 
отрисовка: отрисовки отрисовку отрисовке 
остаться: остался 
расположение: расположения 
внизу: внизу 
понятно: понятно 
пилотный: пилотного 
транспорт: транспорте 
похожий: похожее похожие 
прыгать: прыгать 
команда: команды команду команде команд 
наклейка: наклейки 
ввести: введён введённую 
редактор: редактор 
поддержка: поддержка 
непременно: непременно 
закодировать: закодирована закодированный закодированную закодированного 
выпендрёж: выпендрёж 
локальный: локальное 
покупать: покупали 
задействоваться: задействуются 
заставка: заставку 
пиксельный: пиксельного пиксельным 
текущий: текущей текущую 
ощущение: ощущениям 
адресовать: адресовать 
полезный: полезнее полезная 
прошить: прошит 
визуально: визуально 
записываться: записываются 
прийтись: придётся пришлось 
показать: показать 
почему: почему 
воспроизведение: воспроизведения 
весьма: весьма 
сдвинуться: сдвинемся 
год: году 
крохотный: крохотной 
постараться: постарался постараюсь 
позволять: позволяет 
хаба: хабы 
сложение: сложение 
голова: головы 
модель: модель моделей 
разный: разному разные разных 
странный: странное 
трудность: трудность 
такт: такты такта 
разбираться: разбираться 
минута: минут 
заниматься: занимается 
взять: взять 
скроллинг: скроллинга скроллингом скроллинг 
медленный: медленные 
выглядеть: выглядит выглядят 
подойти: подойдёт 
развилка: развилки 
против: против 
усилие: усилий 
определить: определить 
пригодиться: пригодится 
внутри: внутри 
использование: использование 
быстрый: быстрого быстрее быструю быстрой быстрые 
загрузиться: загрузится 
загрузить: загружена загрузить 
курсор: курсор 
единственный: единственный 
полоска: полоски 
дойти: дойдя 
магнитофон: магнитофоне магнитофона 
воспоминание: воспоминаниями 
ещё: ещё 
фон: фоне фона 
смещение: смещение смещения 
целиком: целиком 
процедура: процедура процедуру процедуры процедурой 
происходить: происходит происходило 
приходиться: приходится 
третий: третья 
ядовитый: ядовитые 
тупик: тупики 
качественный: качественных 
регистровый: регистровая регистровую регистровой 
мой: мои моим 
качество: качестве 
переход: переход переходе перехода 
необычный: необычна 
слишком: слишком 
пара: паре пара пару 
дать: дало 
важный: важное 
блочный: блочной 
бит: биту битах 
шестнадцатеричный: шестнадцатеричные 
мелкий: мелкие 
становиться: становится 
обычно: обычно 
экранный: экранная 
снова: снова 
стираться: стираются 
соответствие: соответствие 
занять: занять 
тег: теги 
знать: знает 
горизонтальный: горизонтальная горизонтальный горизонтального 
выделить: выделить 
ниже: ниже 
соответсвовать: соответсвует 
вниз: вниз 
глобальный: глобального глобальная 
раздел: раздел 
слушать: слушать 
прочтение: прочтение 
добавлять: добавляя 
например: например 
уменьшить: уменьшить 
перемещение: перемещения 
самодельный: самодельный 
редактирование: редактирования 
поэтому: поэтому 
набор: набором 
делать: делать делает 
инжиниринг: инжиниринг 
высота: высоту 
сильно: сильно 
первый: первый первых первую первом первым 
вычислять: вычислять 
статья: статье 
верх: верху 
уместиться: уместится 
счастие: счастью 
слово: словами слово слова 
стена: стены 
принадлежащий: принадлежащие 
дёрганый: дёргано 
случайно: случайно 
система: системы 
очень: очень 
запуск: запуска 
вокруг: вокруг 
игрок: игрока игроку 
небольшой: небольшой 
счёт: счёта 
промежуточный: промежуточное промежуточная промежуточного 
развернуть: развернуть 
данный: данном 
способный: способен 
число: числа 
младший: младший младших 
сводиться: сводится 
источник: источника 
итак: итак 
читатель: читатели 
умножать: умножаю 
подсказка: подсказкой 
получить: получить 
стирать: стирать 
добраться: добрался 
слева: слева 
играть: играть 
смениться: сменится 
роль: роль 
пофига: пофиг 
элемент: элемент элементы элементам 
выигрывать: выигрывая 
занимать: занимал занимает 
любимый: любимая 
некоторый: некоторых 
реверс: реверс 
тестирование: тестирования 
просто: просто 
генерироваться: генерируется 
обратный: обратную 
направо: направо 
побитовый: побитово 
титанический: титанических 
захотеться: захочется захотелось 
играться: играется 
магнитофонный: магнитофонной 
обрезание: обрезания 
всё: всё 
выполняться: выполняется выполнялся 
окно: окно 
иметься: имеется 
версия: версию 
какофония: какофония 
фанат: фанат 
копировать: копирует 
журнал: журнале 
вместо: вместо 
компактность: компактности 
абзац: абзацы 
остальной: остальных остальные 
ясность: ясность 
сверху: сверху 
казаться: казался казалось 
нарисовать: нарисовать 
насмешка: насмешка 
точнее: точнее 
также: также 
предел: пределах 
раскручивать: раскручивать 
заполнять: заполнять 
забрести: забрели 
ясно: ясно 
превратить: превратить 
больший: больших 
испытание: испытанием 
выбраться: выбраться 
пуля: пули 
вправо: вправо 
строчный: строчную 
расчёт: расчёт 
причина: причины 
примитивный: примитивной 
доступный: доступны 
капля: капли 
найти: найдя найти 
приём: приёмы 
этот: эта этих 
мы: нам 
накладывать: накладывать 
вмешательство: вмешательства 
хотеться: хочется 
секунда: секунд 
бродить: бродить 
заполнение: заполнением 
большинство: большинство 
история: истории 
внутрь: внутрь 
тип: тип 
пистолет: пистолет 
рассказать: расскажем 
проходить: проходить проходит 
средний: средний 
обновлять: обновлять обновляла 
точка: точки 
интуитивно: интуитивно 
листинг: листинга листинг 
дёргать: дёрганным 
достаточно: достаточно 
делиться: делился 
процесс: процесс 
подключаться: подключаются 
текст: текста текст 
ввод: ввода ввод 
окошко: окошко 
раскраска: раскраски 
хороший: лучшие хорошая 
отрисовывать: отрисовывать 
исполнить: исполнит 
рекомендовать: рекомендую 
отдельный: отдельные отдельных 
пусть: пусть 
отпустить: отпустил 
сменяться: сменялись 
девяностый: девяностых 
красный: красным 
клон: клон 
формат: форматах форматов 
напечататься: напечатается напечатаются 
проникнуться: проникнуться проникнувшись 
помощь: помощь 
нужный: нужную нужен 
копирование: копирование 
опытный: опытные 
мина: мин 
состоять: состоит 
цветной: цветное цветной цветного 
статический: статические 
вспомнить: вспомнил 
совмещать: совмещают 
забыть: забыл 
стратегичный: стратегичной 
родитель: родители 
работать: работает работать 
раскрутка: раскрутка 
сутки: сутки 
обходиться: обходились 
увеличиваться: увеличивается 
другой: другая другое 
поглядеть: поглядеть 
три: трёх 
показывать: показывают показывает 
настоящий: настоящий 
двухбайтовый: двухбайтовые 
современный: современный 
новый: новых новый новой 
крутой: крутой 
сброс: сброса 
верить: верил 
разработчик: разработчик 
день: дней 
формировать: формирует 
любой: любых 
располагаться: располагались 
удобный: удобными 
вакансия: вакансии вакансий 
создаваться: создаются 
запись: записи 
знак: знаком 
участок: участок 
выше: выше 
соответствовать: соответствует соответствующей 
мультяшный: мультяшная 
быть: будем будут 
загружать: загружать 
сохранение: сохранений 
бесплатный: бесплатных 
данные: данных 
пропускать: пропускать 
примерно: примерно 
поверх: поверх 
побуквенный: побуквенно 
хвост: хвост 
прекрасно: прекрасно 
немного: немного 
противостоять: противостоят 
вроде: вроде 
производить: производит 
верёвка: верёвки 
изучение: изучения 
рейтинг: рейтинг 
кодироваться: кодируются 
выбрать: выбрать 
вы: вами 
ощутимо: ощутимо 
всякий: всякий 
далёкий: дальше 
атрибут: атрибутов 
разработка: разработка 
двигаться: двигаются 
сложно: сложно 
ускоренный: ускоренном 
вертикальный: вертикальный 
способ: способа 
полностью: полностью 
обладать: обладает 
символ: символы 
остановить: остановить 
превращение: превращении 
самостоятельно: самостоятельно 
спектрумский: спектрумской 
заглядывать: заглядывая 
отдельно: отдельно 
количество: количество 
пока: пока 
полный: полный полные 
минимальный: минимальные 
линия: линии 
дисковод: дисководе 
функция: функций 
гораздо: гораздо 
картинка: картинке 
неплохо: неплохо 
понадобиться: понадобится 
цифра: цифры 
определять: определял 
распаковка: распаковка 
закладка: закладки 
видео: видео 
вышеуказанный: вышеуказанный 
пропустить: пропустить 
действие: действий 
жёлтый: жёлтые 
вернуться: вернуться 
многие: многие 
бодрый: бодрее 
отрисовываться: отрисовывается 
подросток: подростком 
пробежать: пробежит 
фаза: фазы 
себя: собой 
порядок: порядке 
записывать: записывать 
хабра: хабр 
кбайт: кбайт 
сложность: сложности 
дом: дома 
сразу: сразу 
выполнить: выполнить 
кадр: кадрами 
главное: главное 
перерисоваться: перерисуется 
кратное: кратное 
край: краям края 
построчно: построчно 
слабость: слабость 
бывать: бывают 
вспомогательный: вспомогательная 
обновить: обновить 
оригинальный: оригинальном 
глубокий: глубокого 
сохранить: сохранить 
закодированый: закодированый 
получиться: получился 
добавиться: добавится 
древний: древней 
распределить: распределена 
логично: логично 
операция: операции 
достигнуть: достичь 
рефлекс: рефлексы 
читать: читают 
вложить: вложенных 
открыть: открыть 
цвета: цветами 
значит: значит 
последовательный: последовательное последовательных 
стоить: стоит 
ребёнок: детей 
публикация: публикации 
новость: новость 
виртуальный: виртуальную 
видеорежим: видеорежим 
известный: известен 
сочетаться: сочетается 
выступать: выступает 
сохраняться: сохраняются 
стык: стыках 
интерпретатор: интерпретатор 
звучать: звучит 
мало: мало 
информация: информация 
ширина: ширину 
записать: записанные 
появляться: появляются 
верхний: верхним 
изнутри: изнутри 
экспериментально: экспериментально 
разгон: разгон 
нынешний: нынешним 
они: ними 
уменьшать: уменьшать 
заставить: заставить 
разбить: разбить 
деньга: денег 
обязательно: обязательно 
сохранять: сохранять 
идея: идей 
повезти: повезло 
о: обо 
наоборот: наоборот 
сложный: сложную 
удерживать: удерживать 
фундаментальный: фундаментальные 
голубой: голубым 
экономия: экономии 
привести: приведёт 
занятный: занятная 
исполнение: исполнения 
дизайн: дизайна 
неправильный: неправильный 
рисование: рисование 
экономный: экономнее 
изменить: изменить 
сказать: сказать 
описывать: описывают 
попытка: попытке 
обновление: обновлениями 
логика: логику 
чернота: черноты 
синий: сине 
снапшот: снапшотом 
быстро: быстро 
читабельность: читабельности 
ограничение: ограничений 
отличный: отличный 
выход: выход 
недавний: недавних 
запускаться: запускается 
обход: обхода 
дух: духом 
мара: мар 
заполняться: заполняется 
звук: звуков 
вообще: вообще 
магнитная: магнитной 
высокий: высокого 
скорость: скорости 
эпоха: эпохи 
направление: направление 
