оказаться: оказаться оказался 
мочь: могут могло могли могла 
система: системе системой система систем 
определяться: определяется определяются 
сравнивать: сравнивать 
реализовать: реализовать реализованы реализует 
перспективный: перспективный 
общий: общего общей общем 
сравниваться: сравнивается 
издержка: издержками 
остановить: остановлены 
маска: маску маске маской 
полуслово: полуслова полуслово полусловами полуслов 
архитектура: архитектур архитектурах архитектуры архитектурой архитектуру архитектура архитектуре 
спасибо: спасибо 
появиться: появившейся появился появилась 
поддерживать: поддерживать поддерживал поддерживает 
плохой: хуже 
расширить: расширенные 
область: области 
упростить: упростить 
использовать: используемой использовать используют использовал использовано использует используя 
являться: является являются 
предел: пределы 
содержимое: содержимому содержимым содержимое 
частность: частности 
типовой: типовым типовых типовыми 
адресация: адресация адресации адресацию 
привести: привели 
указание: указания 
смочь: смог смогла 
сдвиг: сдвигов сдвиг сдвиги 
обновление: обновлением 
давно: давно 
один: одного одну одним одном одна одно одной 
разработка: разработки разработку 
абсолютный: абсолютном абсолютную абсолютный абсолютного абсолютных 
проходить: проходил проходят 
яндекс: яндекс 
позиция: позиций позиции позицию 
вариант: варианте варианта вариантах вариантам варианты вариантов вариант 
кампания: кампания 
технология: технологий технологии 
обзорный: обзорно 
добиться: добиться 
поверить: поверить 
заменяться: заменяется 
назначение: назначение назначения 
нужный: нужны нужен 
вложиться: вложиться 
значение: значение значения значений 
расширяться: расширяются 
выбирать: выбирать 
возможно: возможно 
крах: краху 
успешно: успешно 
память: памяти память памятью 
последний: последнем последнего последний последних последним 
энергопотребление: энергопотребление 
указывать: указывать 
вращать: вращать вращает 
создавать: создавало создаёт 
второе: второе 
логический: логический логической логическими логических логические 
каждый: каждой 
получать: получать 
сравнение: сравнений сравнения сравнению сравнениях 
игнорировать: игнорировать 
комментарий: комментарии 
загрузить: загруженных загрузить 
голос: голосов 
состояние: состояния 
мультискалярность: мультискалярности 
необычный: необычен необычный необычна необычные необычных 
свой: своём свой свои своих своё своим 
особый: особые особая 
меню: меню 
мощный: мощную 
подобный: подобному подобный 
помимо: помимо 
суммарный: суммарного 
удобный: удобнее удобны 
теоретически: теоретически 
особенность: особенностью особенностями 
отличать: отличает 
слот: слот слотами слота слотах слотов 
иметь: имел имеют имела имеет имея имеем иметь имеющим 
регистр: регистре регистров регистра регистрам регистры регистр регистру регистрами 
битный: битные битным битной битное битную битный 
переход: переходами переходу переходы переход переходе перехода переходов переходах 
системный: системные системных системный системной 
часть: часть частей частью части 
медленный: медленнее 
одинаковый: одинаковых 
ограниченный: ограниченное 
знаковый: знакового знаковых знаковом 
любой: любое любую любому любой 
бесполезный: бесполезную 
база: базе базой 
размер: размер 
другой: другим другие других 
увеличить: увеличить 
дробный: дробная 
предположить: предположить 
устройство: устройстве устройств 
вещественный: вещественных вещественными вещественные 
сохранять: сохраняем сохранять 
часто: часто 
набор: наборы 
код: коды кодах кодов 
исключение: исключений исключения 
последующий: последующим последующих 
вид: виду 
существенно: существенно 
такой: такими такие такое такая таких 
побайтовый: побайтовой 
больший: большее большая наибольшее наибольшей 
расчёт: расчёты расчетов расчётов 
задержка: задержкой задержек 
процессор: процессорами процессоры процессорах процессоров процессора процессор процессором 
причина: причинам 
добавить: добавить 
перейти: перешла 
номер: номерами номером 
начало: начало начала 
эквивалентный: эквивалентная 
вставлять: вставляет 
перенос: перенос переносом переноса 
число: чисел числе числа числами число 
однако: однако 
флаг: флаги флаг флагами флага флагов флагу 
адрес: адреса адресу адрес 
хранить: хранит 
очевидный: очевидных 
заморочка: заморочка 
прирост: прирост 
правый: правых 
исполнение: исполнение исполнению исполнения 
рассмотреть: рассмотрим 
нужно: нужно 
вращение: вращений вращения 
условность: условность 
мультискалярный: мультискалярные мультискалярной 
интересно: интересно 
читатель: читателей 
имя: имена 
наименование: наименование 
битый: бит бита биты 
условие: условие условия условий 
случай: случаях случаями случаев случае 
дополнение: дополнением дополнения дополнение 
завершиться: завершившийся 
итого: итого 
внедрение: внедрением внедрение 
аналогичный: аналогичен 
склонение: склонению 
простой: проще простыми просты 
никто: никто 
сделать: сделать сделаны сделан 
сдвигать: сдвигать 
отсутствовать: отсутствует 
ассемблер: ассемблер ассемблерах ассемблеры ассемблера 
получаться: получается 
хранение: хранения 
который: которые которой которая которых который 
язык: языка язык 
идея: идея 
характерный: характерной 
зануление: занулением зануления 
левый: левые 
независимый: независимых 
дзен: дзен 
возможность: возможность возможности 
остаток: остатка 
успех: успехи успехом 
итог: итоге 
поздний: позже 
беззнаковый: беззнакового беззнаковых 
группа: группы группу групп группа 
перемещать: перемещаемой перемещаемая перемещаемых перемещаемую 
первый: первые первый первых первой первым 
тетрада: тетрад тетрада 
делать: делают делать делает 
компьютер: компьютер компьютерах компьютеров 
отмечаться: отмечалось 
загрузка: загрузки загрузке 
набирать: набирать 
подпрограмма: подпрограмму подпрограмм 
четыре: четыре 
поиск: поиск 
выгрузить: выгруженных 
отношение: отношения отношение 
существовать: существует существуют 
лишь: лишь 
компактный: компактные 
унаследовать: унаследованной унаследована унаследовал унаследовано 
сопроцессор: сопроцессор сопроцессорах 
точность: точность 
многозадачность: многозадачность 
избегать: избегать 
карма: карма 
произвольно: произвольно 
ускорить: ускорить 
тип: типа тип 
пройти: прошел 
перемудрённый: перемудрённо 
результат: результате результат результатов результата результаты 
работа: работы работа 
показать: показанные показал 
управление: управления 
математика: математику 
переносить: переносит 
цель: целью 
совершенно: совершенно 
храниться: храниться 
наверное: наверное 
второй: второй 
вычисление: вычислений вычисления 
генерация: генерации 
несколько: несколько нескольких 
последовательность: последовательности последовательность 
решающий: решающими 
соответствие: соответствия соответствие 
недавно: недавно 
декрементироваться: декрементируется 
специальный: специальные специальным специальный специальных 
математический: математических математические математический 
дублировать: дублирующую дублирующие 
настройка: настройка 
сей: сих 
байт: байты байт 
обнаружить: обнаружить 
возможный: возможна возможные возможным 
гибкий: гибкая 
два: двумя двух две 
отдельный: отдельном отдельных 
связь: связи 
найти: нашёл нашедшим 
древний: древнего 
вполне: вполне 
инновация: инновациями 
отстать: отстать 
профиль: профиль 
вызов: вызова вызовы 
давать: даёт дает дают 
быть: буду е 
бизнес: бизнесу 
подойти: подошла 
маленький: меньше маленькой 
неудача: неудачам 
понятный: понятным 
брать: берёт 
нуль: нулей нулём нулями нулем 
вычитание: вычитанием вычитания вычитаний 
тот: тех 
означать: означает 
индексный: индексную индексная 
деление: деление делении деления 
сложение: сложений сложением сложения 
естественный: естественным естественный 
эволюция: эволюции 
установка: установкой установке установки 
самый: самый самая 
метод: методами 
интересный: интересной интересны 
ноль: ноль 
делиться: делятся делится 
инструкция: инструкция инструкцию инструкции инструкций 
частный: частными частное 
стать: стал стала стали 
разработать: разработанный разработан 
старый: старую 
использование: использованию использования использование использованием использовании 
безнадёжный: безнадежным 
программирование: программирования 
пересылка: пересылки 
раз: раза 
переполнение: переполнения 
длинный: длинный 
свойство: свойства 
операнд: операнда 
применение: применение 
половина: половину половине половины 
предусмотреть: предусмотрены 
битов: битов 
выбрать: выбранных выбран 
поддерживаться: поддерживается 
создание: созданию 
её: её 
сорваться: сорвалась 
качественный: качественной 
наличие: наличие наличия 
групповой: групповой групповые 
архаичный: архаичная 
счётчик: счётчика счётчик 
малый: меньшей меньшее 
возврат: возвратов возврата 
разрядный: разрядные разрядную разрядных 
условный: условными условные условных 
необходимый: необходимым необходимы 
миллион: миллионов 
идеология: идеологии 
арифметика: арифметика 
это: это этим 
говорить: говоря 
выпускать: выпускать 
поразрядный: поразрядными поразрядной поразрядные 
заметить: заметить 
занулять: занулять зануляет 
персональный: персональный персональных 
понятно: понятно 
бита: битами 
необычность: необычностью 
стек: стека 
команда: команды командах команд команда 
альянс: альянсом 
получение: получения 
поддержка: поддержка поддержку 
обзор: обзор обзора обзорам 
частота: частотах 
получить: получил получим получить 
единственный: единственная единственный единственном 
учёт: учётом 
компьютерный: компьютерное 
сохранение: сохранения 
слово: слове слов слово слова 
адресовать: адресовать 
ряд: ряд 
сравнить: сравнить 
джон: джоном 
почему: почему 
весьма: весьма 
текущий: текущий текущего 
скорее: скорее 
явный: явным явный 
позволять: позволяет позволяло позволяют 
перекладывать: перекладывать 
хаба: хабы 
разный: разному разное разные разных 
несмотря: несмотря 
виртуальный: виртуальной виртуальная 
рабочий: рабочих рабочей 
подряд: подряд 
лидировать: лидирующих 
операция: операциях операций операциями операции операцию 
битовый: битовую битовых битовые 
получиться: получилось 
похоже: похоже 
образ: образом 
многословный: многословные 
старший: старшей 
выглядеть: выглядит 
рассматриваться: рассматривалась 
быстрый: быстрого быстрый быстрым быстрые быстрыми 
пользователь: пользователь 
список: список 
арифметический: арифметических арифметические 
название: названия названий название 
умолчание: умолчанию 
замена: замена 
ещё: ещё 
использоваться: использовался использовалась используется 
упомянуть: упомянуть 
фон: фоне 
обозначение: обозначение 
смещение: смещение смещением 
микропроцессор: микропроцессоры 
успешный: успешный успешным 
политика: политике политики 
дальнейший: дальнейшие 
качество: качестве 
большинство: большинстве 
устанавливать: устанавливать устанавливают 
среди: среди 
необычно: необычно 
обычно: обычно 
тег: теги 
сбросить: сброшен сбросить 
поместить: поместить 
целочисленный: целочисленные целочисленных целочисленного 
станция: станции станциях 
уровень: уровень 
фирма: фирмы 
встроить: встроенный встроенная 
предоставиться: предоставилась 
прочтение: прочтение 
сдвигатель: сдвигателем сдвигателя 
например: например 
благодаря: благодаря 
попрограммировать: попрограммировать 
прежде: прежде 
оно: оно 
описать: описанными описаны 
поэтому: поэтому 
неудобство: неудобства 
история: история истории 
производительность: производительности производительность 
никакой: никакого 
особенно: особенно 
предсказатель: предсказателю 
дополнительный: дополнительные 
сильно: сильно 
аргумент: аргументов 
главный: главной 
полезно: полезно 
глобальный: глобальной 
ознакомить: ознакомить 
обилие: обилие 
отрицательный: отрицательное 
очень: очень 
прикладной: прикладного 
параллельный: параллельное 
конец: конец концу 
рад: рад 
называть: называли 
буква: буква 
знакомство: знакомстве 
помочь: помочь 
время: времен время 
кроме: кроме 
эмулятор: эмулятор 
мб: мб 
элемент: элемент элементы 
старое: старое 
роль: роль 
действительно: действительно 
неясный: неясным 
железо: железо 
страничный: страничная 
обычный: обычные 
просто: просто 
место: место 
подсказка: подсказку 
указанный: указанное 
практический: практические 
эффективный: эффективнее 
выполнение: выполнения выполнении 
назад: назад 
невыровненный: невыровненные 
порядок: порядком 
обрабатываться: обрабатываются 
замечание: замечания 
версия: версию 
хотя: хотя 
странно: странно 
вместо: вместо 
остальной: остальных остальные 
двухадресный: двухадресные 
интуиция: интуиция 
причём: причем 
пробовать: пробовала 
известный: известных 
также: также 
строковый: строковой 
безусловный: безусловных безусловный 
развиваться: развивается 
помещать: помещать 
данный: данного 
вставка: вставку вставок 
проблема: проблемы 
соответствующий: соответствующие 
вправо: вправо 
замедлять: замедляет 
сложность: сложность сложности 
нетипичный: нетипичная 
наиболее: наиболее 
доступный: доступны 
критический: критические 
сбивать: сбивать 
связный: связной 
этот: эта этих 
константа: константой константу константами констант константы 
выгодно: выгодно 
характеристика: характеристикам 
неуклюже: неуклюже 
отражать: отражает 
вызывать: вызываем 
технический: техническим техническая 
реально: реально 
комбинировать: комбинировать комбинируя 
кратный: кратный 
средний: средний 
некоторый: некоторые 
комментировать: комментировать 
процесс: процесс 
следствие: следствием 
звучный: звучным 
практически: практически 
умножать: умножать 
хороший: лучшие 
соответствовать: соответствуют соответствует 
массовый: массовых 
она: неё 
подрыв: подрыву 
вычитать: вычитать 
следовать: следует 
аналогично: аналогично 
копироваться: копируется 
заносить: заносит 
бо: бо 
отличаться: отличающихся отличается 
строго: строго 
оба: оба обоих обеих 
мина: мин 
многообразие: многообразия 
устанавливаться: устанавливается 
сделка: сделка 
мнемоник: мнемоникам мнемоник мнемоники 
неопределённость: неопределенность 
работать: работает 
влево: влево 
экзотический: экзотические 
выгружать: выгружать 
высокочастотный: высокочастотные 
ю: ю 
сутки: сутки 
увеличиваться: увеличивается 
заложить: заложена 
продолжать: продолжает 
сложный: сложных 
новый: новых 
проигнорировать: проигнорирован 
весь: всем всеми 
восемь: восьми 
преимущество: преимуществ преимущества 
закрытый: закрыт 
странный: странные 
банально: банально 
гибкость: гибкостью 
эмоциональный: эмоциональная 
связать: связана 
финальный: финальному 
полный: полных 
знак: знаком 
выше: выше 
льший: льшие 
начать: начатая 
неофициальный: неофициальная 
данные: данных 
сам: сама 
усовершенствовать: усовершенствованной 
эквивалентность: эквивалентность 
неизменный: неизменными 
обратный: обратным 
мейнфрейм: мейнфреймах мейнфреймов 
мв: мв 
наслать: нашли 
краткий: краткая 
немного: немного 
производить: производит 
рейтинг: рейтинг 
продать: продано 
умножение: умножения умножение 
производство: производством 
рон: рон 
отсутствие: отсутствие 
немой: нем 
способ: способом 
количество: количество 
контролироваться: контролировался 
либо: либо 
гораздо: гораздо 
эмуляция: эмуляцию 
довольно: довольно 
неплохо: неплохо 
закладка: закладки 
изначально: изначально 
предпочесть: предпочла 
большой: большому 
др: др 
пора: пор 
аппаратный: аппаратное 
похожий: похожие 
модель: модели 
вернуться: вернуться 
многие: многие 
проиграть: проиграла 
насчитать: насчитать 
векторный: векторную 
хабра: хабр 
впервые: впервые 
именовать: именовать 
неожиданность: неожиданностью 
момент: момент 
кок: коком 
сразу: сразу 
толк: толку 
главное: главное 
хватать: хватает 
обновить: обновить 
компания: компаниями 
сумма: суммы 
задерживать: задерживала 
присутствовать: присутствует 
состояться: состоялась 
основа: основе 
исключать: исключающего 
просмотр: просмотров 
публикация: публикации 
упрощённый: упрощенных 
десяток: десятков 
инвертировать: инвертировать 
заключение: заключении 
писать: писать 
несистемный: несистемного 
так: т 
заметный: заметные 
ассемблерный: ассемблерные 
задаваться: задаётся 
короткий: короткий 
мало: мало 
кэш: кэшем 
указатель: указателя 
х: х 
подсчёт: подсчет 
намного: намного 
менять: меняют 
отличие: отличие 
синхронизация: синхронизации 
середина: середины 
широкий: широкому 
фактически: фактически 
оптимизация: оптимизация 
грузить: грузить грузили 
отказаться: отказались 
создать: создан 
рекордно: рекордно 
исполняться: исполняются 
трудно: трудно 
повышать: повышающий 
ит: ит 
бессмысленно: бессмысленно 
подсказать: подсказать 
параллельно: параллельно 
основной: основные 
индивидуальный: индивидуальной 
час: часов 
выгрузка: выгрузки 
целый: целых 
вообще: вообще 
сначала: сначала 
прототип: прототипа 
состав: составе 
к: ко 
направление: направление 
