страна: страны 
весь: весь вся 
логика: логика 
ввиду: ввиду 
репутация: репутация 
неодобрение: неодобрения 
мочь: могут могли 
подхлестнуть: подхлестнули 
степень: степени 
банковский: банковскую банковской банковская банковских 
паника: панику 
конечный: конечном 
плотный: плотный 
пригодный: пригодной 
унести: унес 
спасибо: спасибо 
блокчейн: блокчейн 
денежный: денежном денежных 
актив: активам активов 
американский: американскую американская американской 
рыночный: рыночного рыночные 
выйти: выйти 
маркетинговый: маркетинговая 
крупный: крупный крупной крупные крупнейший 
ценный: ценные 
внимание: внимание 
заявить: заявили заявил 
пользователь: пользователи пользователям пользователя пользователей 
яндекс: яндекс 
поскольку: поскольку 
депонировать: депонировало 
резерв: резервы резерва резервов 
простой: простая 
возможно: возможно 
зарегистрировать: зарегистрированные 
укрепить: укрепить 
привязка: привязку привязки 
средство: средств средства 
напрямую: напрямую 
участвовать: участвовать 
упасть: упасть упал 
система: система системы систему 
комментарий: комментарии комментариях 
подробный: подробней 
размер: размеру размер 
беспокоиться: беспокоятся 
инвестор: инвесторов инвестор 
голос: голосов 
вторичный: вторичного 
обеспечение: обеспечение обеспечения обеспечении 
выходить: выходить выходят 
объяснять: объяснял 
стоить: стоить 
реальный: реальные 
стейблкоина: стейблкоина стейблкоин стейблкоинами стейблкоины 
наличный: наличные наличных 
меню: меню 
связать: связан 
должный: должны должна 
посмотреть: посмотреть посмотрим 
работать: работающий 
который: которыми которые которая который которую котором 
учреждение: учреждение 
май: мая 
связанный: связанные 
банк: банку банкам банке банк банка банков банках 
иметь: имел имеют имеет 
бумага: бумаги 
часть: часть 
продолжать: продолжают 
конкретно: конкретно 
пикантность: пикантность 
прямой: прямую 
инвестировать: инвестировали инвестирована 
крипта: крипта 
стать: ставших станет стали 
предположить: предположить 
понедельник: понедельник 
доллар: доллару долларах доллар доллара доллары долларов 
умудриться: умудрился 
правительственный: правительственной 
дно: дно 
нерабочий: нерабочее 
войти: войдите 
свой: свой свои своих своим 
пообещать: пообещав 
храниться: хранятся 
добавить: добавить 
однако: однако 
захотеть: захочет 
использовать: использовали использовать используют 
зависеть: зависит 
верить: верят 
тревожный: тревожно 
стабильный: стабильную стабильная стабильна стабильных 
кто: кого 
находиться: находятся находились 
создать: созданную создала 
пожалуйста: пожалуйста 
капитал: капитал капиталом 
привязать: привязана 
распределние: распределние 
поговорить: поговорим 
предположим: предположим 
сделать: сделать 
глава: глава 
другой: другими другая другие других 
язык: языка язык 
контрагент: контрагент контрагентами 
течение: течении 
дзен: дзен 
аналитика: аналитика аналитикой 
пытаться: пытаются пытаясь 
высказаться: высказался 
статья: статью статьи 
итог: итоге 
стартап: стартапов стартапами 
стейбнуть: стейбла 
частично: частично 
первый: первые первое 
курс: курс курса курсы 
стресс: стресса 
полагаться: полагаться полагаются 
поиск: поиск 
финансовый: финансовой финансовых финансовым финансовый финансового 
глубоко: глубоко 
аудит: аудит 
отношение: отношения отношение 
грозить: грозить 
капиталлизация: капиталлизации 
фигурка: фигуркой 
карма: карма 
дата: дата 
утечь: утекли 
обуздать: обуздать 
событие: событий 
результат: результате 
операционный: операционной операционных 
второй: второй 
неплатёжеспособность: неплатежеспособности 
разрыв: разрывам 
равный: равным 
проголосовать: проголосовали 
близкий: ближайших ближайшие 
потенциал: потенциал 
недавно: недавно 
рисковать: рисковать 
гарри: гарри 
долина: долины 
вернуть: вернет 
сегодня: сегодня 
настройка: настройка 
монета: монет монета монету 
сожаление: сожалению 
составлять: составляли 
необходимо: необходимо 
заявление: заявления 
избежать: избежать 
профиль: профиль 
прочий: прочих 
товарооборот: товарообороте 
хотеть: хочет хотите 
отдельный: отдельный 
зацепить: зацепило 
ситуация: ситуация ситуации ситуацию 
негатив: негатив 
покупать: покупая 
официальный: официальный 
протокол: протокол 
снижаться: снижается 
долгосрочный: долгосрочный 
плохой: худшем 
развитие: развитием 
надёжный: надежные 
потеря: потере потеря потерях 
действовать: действующих 
пруфа: пруфы 
основный: основное 
материнский: материнской 
смочь: смогли сможет 
финансы: финансы финансам 
драйвер: драйвер 
старый: старую 
дисконт: дисконтом дисконт 
этот: этому эта 
касаться: касается 
предстоять: предстоит 
выходной: выходные 
сторона: сторона 
внести: внесла внес 
баланс: баланс 
подорвать: подорвана 
обмен: обмен 
увидеть: увидеть 
уровень: уровня уровень 
чрезвычайно: чрезвычайно 
г: г 
послезавтра: послезавтра 
многий: многих 
фигурировать: фигурируют 
управляться: управляются 
думать: думаю думаете 
это: это этим 
сми: сми 
пауэлла: пауэлл 
обеспечить: обеспечен 
день: дни день дней 
понятно: понятно 
гигант: гигантами 
полезный: полезными 
использование: использования 
беда: беды 
размен: размена 
продажа: продажу 
новость: новостями новость 
поддержка: поддержка поддержки 
материал: материале материалах материалами 
дополнительный: дополнительной 
дойти: дошла 
поток: потоках потока 
лежать: лежали 
якобы: якобы 
потерять: потеряете потерял 
хранить: хранить хранят хранил 
хранение: хранении 
сеть: сеть 
почему: почему 
обвинить: обвинили 
читать: читаете 
субъективный: субъективному 
скорее: скорее 
неделя: недели недель 
подписываться: подписывайтесь 
хаба: хабы 
калифорнийский: калифорнийским 
несмотря: несмотря 
заражение: заражение заражения 
венчурный: венчурных венчурный венчурным 
следующий: следующие следующей 
сильный: сильный 
выглядеть: выглядит 
стабильность: стабильность 
криптовалютный: криптовалютными 
разбор: разбор 
февраль: февраля 
воспоминание: воспоминаниями 
ещё: ещё 
арбитражник: арбитражников 
цент: цента 
конец: конца 
придавать: придают 
получение: получении 
неспокойный: неспокойный 
говорить: говорили 
тег: теги 
выяснить: выяснили 
следить: следящей 
начаться: начался начались 
объявить: объявил 
ниже: ниже 
дешёвый: дешевле 
рада: рады 
менеджмент: менеджмент 
млн: млн 
прочтение: прочтение 
защищать: защищать 
месяц: месяца 
например: например 
делиться: делимся 
куча: кучу 
поэтому: поэтому 
компания: компании компания 
никакой: никакого 
кремниевый: кремниевой 
подогревать: подогревает 
неподтверждённый: неподтвержденные 
несколько: нескольких 
опуститься: опустился 
около: около 
ночью: ночью 
сша: сша 
очень: очень 
вокруг: вокруг 
лайк: лайк 
важный: важный 
небольшой: небольшой 
кроме: кроме 
инновация: инноваций 
торговаться: торгуется 
топ: топ 
человек: люди 
вывод: выводы 
польза: пользу 
насколько: насколько 
отток: оттоком отток 
восстановиться: восстановится 
чёрный: чёрный 
выплата: выплат 
подобать: подобает 
деньга: деньги 
разрушить: разрушить 
механизм: механизм 
завалить: завалить 
успокоить: успокоить 
фрс: фрс 
выжить: выживет 
место: место 
запас: запасы 
крипторынок: крипторынку крипторынок крипторынка 
важно: важно 
акция: акций 
эмитент: эмитент 
назад: назад 
версия: версию 
уменьшиться: уменьшились 
наш: нашей нашему нашем 
причём: причем 
сегодняшний: сегодняшнем сегодняшний 
вызволить: вызволить 
крах: краха крахе крах 
восставновление: восставновление 
написание: написания 
защита: защиты 
повод: поводу 
также: также 
писать: писали 
полный: полное 
млрд: млрд 
счёт: счетах 
криптоиндустрия: криптоиндустрии 
делать: делает 
проблема: проблемы 
остаться: оставшихся 
понестись: понесется 
откупать: откупать 
восстановить: восстановить восстановил 
справиться: справился 
рынок: рынка рынок 
история: истории 
поддерживать: поддерживаемые 
обменивать: обменивать 
средний: средний 
стейблкоин: стейблкоинов 
кеш: кеш 
последний: последние 
дело: дела дело 
игрок: игроки 
домино: домино 
хороший: лучшие 
произойти: произошло 
больший: большие большей 
депозит: депозитов 
миллиардер: миллиардер 
пережить: пережить 
ранее: ранее 
утянуть: утянул 
следовать: следует 
они: ими ними 
срочный: срочных 
скромный: скромному 
сайт: сайт 
экман: экман 
вопрос: вопрос 
опустошать: опустошать 
представить: представить 
сценарий: сценарий 
мина: мин 
краткосрочный: краткосрочных 
риск: риск рисков 
воздержаться: воздержались 
такой: таким 
давать: давайте 
факт: факт 
сутки: сутки 
билл: билл 
вызвать: вызвала 
диверсификация: диверсификацией 
лидер: лидерами 
мера: меры 
затрата: затрат 
показывать: показывают 
набег: набег 
ликвидация: ликвидации 
просьба: просьбы 
разработчик: разработчик 
угрожать: угрожает 
департамент: департаментом 
трежерь: трежерях трежери 
отразиться: отразиться 
остальной: остального остальные 
закрытый: закрыт 
совокупность: совокупности 
технология: технологии 
случиться: случилось 
канал: канале 
вакансия: вакансии вакансий 
исключение: исключением 
объём: объем объема 
банкинг: банкинга 
криптостартап: криптостартапов 
выше: выше 
быть: будем 
зависимость: зависимость 
частный: частный 
вылиться: вылиться 
выпускаться: выпускались 
экономика: экономики 
мнение: мнением мнению 
примерно: примерно 
тэн: тэн 
задействовать: задействованы 
мрд: мрд 
отвязка: отвязка 
мск: мск 
рейтинг: рейтинг 
й: й 
утерять: утеряно 
каждый: каждый 
волна: волну 
два: двух 
далёкий: дальше 
введение: введение 
технический: техническая 
криптовалюта: криптовалюта криптовалют криптовалюты 
полностью: полностью 
известный: известный 
количество: количество 
заявка: заявки 
пока: пока 
обанкротиться: обанкротится 
фонд: фонды 
район: районе 
поехать: поехали 
эмиссия: эмиссии 
опрос: опросе 
гораздо: гораздо 
наблюдать: наблюдаем 
тема: тему 
буквально: буквально 
закладка: закладки 
написать: напишем напишите 
математический: математическую 
банкротство: банкротства 
действие: действий 
др: др 
похожий: похожие 
вернуться: вернуться 
отрасль: отрасли 
остановить: остановил 
партнёр: партнерах 
многие: многие 
облигация: облигации 
выпускать: выпускающая 
смысл: смысл 
себя: собой 
сказать: сказал 
порядок: порядке 
представитель: представители 
зарплата: зарплат 
хабра: хабр 
равняться: равняться 
работа: работа 
возможный: возможного возможным 
сложность: сложности 
достаться: досталось 
момент: момент моменту 
март: марта 
кэш: кэша 
час: часа 
четверг: четверг 
криптоэкономика: криптоэкономика 
проникнуть: проникло 
обновить: обновить 
угроза: угрозой 
название: название 
деятельность: деятельности 
спасение: спасению 
время: время 
звоночек: звоночки 
оказаться: окажется 
дать: данные 
принимать: принимать 
уйма: уйма 
просмотр: просмотров 
публикация: публикации 
порассуждать: порассуждаем 
кредит: кредитов 
возможность: возможности 
источник: источник 
голосование: голосовании 
вариант: вариант 
ликвидность: ликвидности 
узнать: узнать 
попытка: попытки 
данный: данный 
вид: виды 
информация: информация 
подача: подачи 
разбросать: разбросаны 
эффект: эффект 
мир: мира 
эквивалент: эквиваленте 
рассмотреть: рассмотреть 
помощь: помощи 
трудно: трудно 
случай: случае 
тысяча: тысячи 
медаль: медали 
попробовать: попробуем 
неизвестный: неизвестное 
январь: января 
разменивать: разменивать 
разобрать: разберем 
пара: пару 
падение: падение 
депегий: депег 
вместе: вместе 
алгоритмический: алгоритмическому 
инфляция: инфляцию 
