процесс: процессы процессами процесс процессов процессах 
мочь: могут могли 
влиять: влияло 
опрос: опрос опросов 
приложение: приложения приложение приложением 
создать: создана создали создать 
различный: различных 
непозволительно: непозволительно 
наряд: нарядов наряд наряда наряды 
поддерживать: поддерживать 
платформа: платформы платформа 
частность: частности 
привести: привели 
федеральный: федерального 
подход: подходах подход 
срочно: срочно 
работать: работали работать 
корпоративный: корпоративное 
вступить: вступили 
разработка: разработки разработке разработка 
человеческий: человеческого 
криптография: криптографией криптографии 
яндекс: яндекс 
юзабельный: юзабельного 
здоровье: здоровье 
отличаться: отличаются 
нужный: нужны нужные 
нудный: нудных 
газоснабжение: газоснабжение 
производственный: производственной производственных 
рассказать: рассказать 
медленно: медленно 
режим: режиме 
трудозатрата: трудозатрат 
документ: документ документах документы документа 
менеджмент: менеджменту 
бумажный: бумажные бумажный 
анализ: анализа анализ 
система: система системы систему систем 
получать: получать 
отрасль: отраслью отрасли 
бюрократический: бюрократического бюрократических бюрократическим 
профсоюз: профсоюзами 
один: одну одно одной 
знать: знаете знаем 
комментарий: комментарии 
автоматизировать: автоматизировать 
год: год годом 
проблемный: проблемных 
риск: риски риск 
голос: голосов 
определённый: определенным 
далёкий: далекое 
продукт: продуктом продуктов продукты продукт продукта 
мобильный: мобильных мобильное мобильного 
прибыль: прибыли 
лояльный: лояльный 
состояние: состоянию 
делопроизводство: делопроизводстве 
меню: меню 
разработать: разработали разработать 
тот: тому те тех 
должный: должны должна 
фокус: фокусе 
внедрение: внедрения внедрений 
неизбежный: неизбежными неизбежны 
помимо: помимо 
функция: функции функций 
идти: идёт 
фсб: фсб 
труд: труда 
внезапно: внезапно 
забыть: забыли забыть 
контроль: контроля 
бумага: бумаги бумагу бумагой 
требование: требованиям требований требования 
квалификационный: квалификационных 
исключительный: исключительное 
часть: часть 
конкретно: конкретно 
правовой: правовым 
ряд: ряду 
сила: силу 
эволюция: эволюция 
конец: конце 
коммент: комментах 
безопасность: безопасности безопасность 
высокий: высокая 
упираться: упиралось 
просмотр: просмотр просмотров 
именно: именно 
непроизводственный: непроизводственное 
корпорация: корпораций 
часто: часто 
регулирование: регулирования 
существенно: существенно 
вручную: вручную 
прекратиться: прекратится 
такой: такими такого таких 
внедрить: внедрен 
закономерно: закономерно 
советский: советских 
речь: речь 
представитель: представителями 
локальный: локальным 
выдумывать: выдумывать 
доработать: доработанный 
добавить: добавить 
представлять: представляло 
государство: государство 
охрана: охраны 
простой: простоями проще простоя 
естественно: естественно 
проинструктировать: проинструктировали 
подпись: подписи подписей 
кто: кого 
нужно: нужно 
уменьшать: уменьшая 
жизнь: жизнь жизни 
устройство: устройствах устройств 
ответственный: ответственных 
ранний: раньше ранней 
госсектор: госсекторе 
важный: важную 
вид: виде видам видов 
возможность: возможностью возможность 
нефтегазовый: нефтегазовой 
сделать: сделать сделано 
язык: языка язык 
который: которые которым которой который которое 
идея: идея 
требовать: требует 
рабочий: рабочего 
подписывать: подписывать 
дзен: дзен 
друг: другом друг 
итог: итоге итог 
попотеть: попотеть 
поздний: позже 
группа: группы 
спасать: спасают 
закрыть: закрыть 
практика: практика 
самописный: самописных 
кусок: кусках 
получить: получат получили 
допуск: допуска допусков допуски допуск 
услышать: услышали 
поиск: поиск поиском 
юридический: юридических 
костыль: костыли 
единый: единой 
глубоко: глубоко 
использовать: использовать использовал используя 
статус: статусов 
привычный: привычных 
карма: карма 
закон: законов 
клиент: клиент клиента 
ускорить: ускорить 
рубль: рублей 
предприятие: предприятиях предприятий предприятие 
тип: типа типов 
работа: работы работу работ работах работам 
миллион: миллионы 
фронтенд: фронтенда 
содержать: содержит 
немедленно: немедленно 
управление: управления 
вызвать: вызваны 
архитектура: архитектуры 
электронный: электронный электронных электронного электронные 
второй: второй вторую 
текущий: текущих 
продавать: продаём 
несколько: несколько 
место: месте местах 
интеграция: интеграция 
рядовой: рядовым 
последовательность: последовательность 
чинить: чинить 
цифра: цифру 
двое: двоих 
сегодня: сегодня 
опасный: опасные опасных 
решение: решений решение решения 
боль: боли 
настройка: настройка 
несопоставимый: несопоставимо 
поле: полей поля 
связь: связи 
абстрактный: абстрактными 
профиль: профиль 
очередь: очередях 
зависимость: зависимости 
гибкий: гибкую гибкой 
законодательство: законодательством законодательству законодательства законодательстве 
планироваться: планируются 
ошибка: ошибки ошибками 
следствие: следствие 
осознавать: осознают 
плохо: плохо 
означать: означает 
проходить: проходило 
тенденция: тенденцию 
пк: пк 
завод: заводов 
действовать: действующих 
чреватый: чреваты чревата 
согласно: согласно 
масса: масса 
нужность: нужности 
показать: показала 
целлюлоза: целлюлозы 
нефть: нефти 
масштабировать: масштабировать 
хождение: хождением 
старый: старую 
удовольствие: удовольствием 
невозможно: невозможно 
значительно: значительно 
исключительно: исключительно 
обивание: обиванием 
российский: российские российском 
решить: решили решить 
централизация: централизации 
её: её 
штраф: штрафы 
качественный: качественной 
россия: россии 
многий: многих 
универсальный: универсальному 
основный: основных 
сравнивать: сравнивая 
условие: условия 
руководитель: руководителей 
это: это этим 
обязательный: обязательные обязательной 
уголовный: уголовным 
подготовка: подготовки 
архитектурный: архитектурных 
принять: принято приняли 
принимать: принимающие 
квалификация: квалификации 
провести: провели 
выдать: выданных 
платить: платить 
бригада: бригадах 
понятно: понятно 
задача: задачу 
самый: самых 
наш: нашу нашего наш нашему нашем наша 
бэкэндом: бэкэндом 
поддержка: поддержка 
сетка: сетка 
сам: сами само 
пр: пр 
аварийный: аварийных 
организация: организациях 
трансформация: трансформации 
пожирать: пожиравшим 
субъективный: субъективному 
скорее: скорее 
крупный: крупных 
хаба: хабы 
эдо: эдо 
свой: своих 
проектирование: проектирование 
появиться: появилась появились 
выстраивание: выстраивание 
семь: семи 
получиться: получилось получилась 
создавать: создавать создавали 
близкий: ближе 
регулятор: регуляторы регулятору регуляторов 
менеджер: менеджеров 
происходить: происходят происходит 
использование: использование 
туториал: туториал 
время: времени время 
быстрый: быстрого быстрее 
сломаться: сломалось 
пользователь: пользователь пользователей 
основной: основной 
сотрудник: сотрудники сотрудников сотрудникам 
полноценный: полноценной полноценный 
бизнес: бизнеса бизнесе бизнес 
ещё: ещё 
банальный: банального 
всплыть: всплыл 
зверь: зверя 
проблема: проблем проблемы 
инфраструктура: инфраструктуру 
отличие: отличиях 
сократить: сократил 
работник: работников 
задержка: задержки 
ожидание: ожиданием 
палата: палату 
качество: качестве 
готовый: готового готовы 
среди: среди 
интерфейс: интерфейс 
ведомство: ведомств 
принцип: принципе 
тег: теги 
оформление: оформлением оформления 
выяснить: выяснили 
объединение: объединению 
лицензия: лицензия лицензии лицензий 
документооборот: документооборот документооборотом документообороте документооборота 
подстроить: подстроены 
неверно: неверно 
прочтение: прочтение 
например: например 
стремиться: стремятся стремится 
поэтому: поэтому 
история: история 
максимально: максимально 
компания: компании компания компаний 
особенно: особенно 
дальнейший: дальнейшем 
делать: делать 
легко: легко 
первый: первый первой 
ремонтный: ремонтных 
скромность: скромности 
вопрос: вопросы вопрос вопросах вопросом 
кабинет: кабинеты 
большой: побольше 
агрегатор: агрегатором 
выполнять: выполнять 
неудобно: неудобно 
травма: травм травмы 
выдумывание: выдумывание 
вокруг: вокруг 
каждый: каждого 
данные: данными данных 
ленивый: ленивый 
сложный: сложным 
кроме: кроме 
способный: способен 
разный: разных 
логика: логики 
человек: люди 
польза: пользу 
насколько: насколько 
подискутировать: подискутируем 
рф: рф 
внутрикорпоративный: внутрикорпоративное 
автоматизация: автоматизации 
преследование: преследованием 
некоторый: некоторых некоторые 
аналог: аналоги 
лицензирование: лицензирования лицензирование 
похоронить: похоронить 
потенциальный: потенциальных 
право: прав 
думать: думаем 
задаться: задался 
всё: всё 
выполнение: выполнения выполнении 
предусмотреть: предусмотрели 
заказчик: заказчика 
версия: версию версии 
хотя: хотя 
устранять: устраняют 
хронофаг: хронофагом 
остальной: остальных 
проводиться: проводятся 
понять: понять 
соответствовать: соответствовать соответствующей 
применять: применять применяли 
внедряться: внедряются 
стать: стало 
также: также 
лицемерный: лицемерной 
неизбежно: неизбежно 
недостаточно: недостаточно 
эцп: эцп 
поедаться: поедалось 
администрирование: администрирование 
минтруд: минтруда 
рынок: рынке 
сложность: сложность 
наиболее: наиболее 
немалый: немалых 
консалта: консалт 
мы: нам 
обмен: обмена 
архаичный: архаичных 
большинство: большинство 
минцифра: минцифры 
кратный: кратно 
масштабироваться: масштабируется 
подумать: подумали 
характерный: характерная 
справляться: справлялся 
предвзятый: предвзятому 
слышать: слышал 
практический: практическую 
практически: практически 
выезжать: выезжать 
какой: какие 
хороший: лучшие 
прийтись: пришлось 
превосходить: превосходят 
убыток: убытков убытки 
вчера: вчера 
коммерческий: коммерческого 
запустить: запустить 
измениться: изменилась 
сократиться: сократилось 
порог: порогов 
инструмент: инструментов 
сайт: сайт 
передовой: передовых 
старт: старта 
круг: кругам 
продать: продать 
отметить: отметить 
доступ: доступа 
массовый: массового 
мина: мин 
еае: еае 
прийти: пришла 
опираться: опиралась 
формальность: формальностей 
он: нём 
фстэк: фстэк 
связанный: связанных 
объявить: объявлен 
ручной: ручном 
суть: сути 
сутки: сутки 
крайне: крайне 
увеличиваться: увеличивается 
приступить: приступить 
соответствие: соответствии 
отслеживать: отслеживать 
день: дней 
адаптировать: адаптированный 
иначе: иначе 
промышленный: промышленного промышленной промышленных 
изменение: изменения изменение 
фраза: фразами 
исключить: исключить 
хватать: хватало 
база: баз 
профильный: профильных 
цифровой: цифровой 
получение: получением 
подтвердить: подтверждена 
переработка: переработкой 
опасаться: опасаться 
прототип: прототипом 
остановиться: остановится 
правило: правило 
ради: ради 
идеальный: идеальная 
гордиться: гордимся 
дорогой: дороже 
слово: словом 
общественный: общественную 
выгрузка: выгрузку 
наслать: нашли 
будущее: будущего 
рейтинг: рейтинг 
важность: важности 
й: й 
вы: вами 
другой: другие 
отсутствие: отсутствием 
больший: большую 
модуль: модуля 
технический: техническая 
вина: вине 
хотеть: хотят 
долгий: долгим долгий 
возникать: возникали 
элемент: элементов 
отдельно: отдельно 
облегчить: облегчить 
количество: количество 
производство: производства производстве 
пока: пока 
гост: гостам 
инцидент: инцидентов 
составление: составление 
многочисленный: многочисленных 
инфополе: инфополе 
отдельность: отдельности 
закладка: закладки 
занимать: занимает 
фильтрация: фильтрации 
последний: последнее 
действие: действий 
любой: любая 
современный: современного 
оптимальный: оптимальнее 
наличие: наличия 
похожий: похожие 
вернуться: вернуться 
конкурировать: конкурирующими 
импортозамещение: импортозамещение 
обобщить: обобщить 
перевести: перевести 
факап: факапы 
счёт: счёт 
внедрять: внедрять 
хабра: хабр 
производительность: производительность 
фильтр: фильтр 
сразу: сразу 
момент: момент 
пообщаться: пообщались 
наработаться: наработавшись 
час: часа часов 
специализировать: специализированный 
обновить: обновить 
посетить: посетили 
воспользоваться: воспользоваться 
проверить: проверить 
операция: операции 
ад: ада 
велосипед: велосипеда 
никак: никак 
виза: визы 
необходимость: необходимости 
публикация: публикации 
нерациональный: нерациональным 
микросервисный: микросервисного 
источник: источник 
так: т 
первоочерёдный: первоочередно 
заполнение: заполнению 
заключение: заключения 
оформляться: оформляться 
обнести: обнесут 
оказаться: оказавшихся 
сухо: сухо 
быть: будут 
деньга: денег 
избавиться: избавившись 
намеренно: намеренно 
пост: пост 
использоваться: использовалось 
оптимизация: оптимизация 
порой: порой 
добыча: добыча 
колоссальный: колоссальное 
внеплановый: внеплановых 
отказаться: отказались 
скоро: скоро 
проведение: проведения 
акт: актом 
актуальный: актуальных 
зоопарк: зоопарком 
выраженный: выраженным 
июль: июля 
валидация: валидации 
помощь: помощи 
случай: случае 
тысяча: тысячи 
блог: блог 
являться: являлось 
дорога: дорогой 
быстро: быстро 
фактор: фактора 
очевидный: очевидно 
допустить: допущены 
заинтересовать: заинтересованы 
заполняться: заполняется 
нередко: нередко 
активно: активно 
стоять: стоят 
новый: новой 
особенность: особенности 
видеть: видим 
соответствующий: соответствующего 
перенасытить: перенасыщено 
мнение: мнению 
