мочь: могут 
обоснование: обоснование 
ответчик: ответчика ответчиком ответчик ответчику 
ваш: ваш 
конституционный: конституционного конституционных 
клиент: клиентам клиентами клиента 
приложение: приложения приложении приложение 
рука: руках 
свой: своего свои своими 
подписать: подписанному подписанным подписавшего подписанная подписан 
считаться: считается 
простой: простые простая простой 
являться: является 
путём: путем 
сервис: сервиса сервис сервису сервисе 
направляться: направляется 
поле: поле поля 
выдержка: выдержки 
действие: действия 
константинов: константиновой 
документ: документом документ документах документы документу документов документа 
допустить: допустим 
яндекс: яндекс 
приводить: приводим 
доказать: доказать 
система: система системы систем 
позволять: позволяющие позволяет 
комментарий: комментарии 
апл: апл 
акт: акту актов акта 
подпись: подписью подписи подпись 
голос: голосов 
специальный: специальное 
бронирование: бронирования 
ввести: ввел введенный 
асп: асп 
записать: записаны 
меню: меню 
суд: суда суде суду суд 
сохранение: сохранением 
достаточный: достаточным 
ряд: ряда 
конфиденциальность: конфиденциальности 
сила: силу 
взаимодействие: взаимодействие взаимодействии взаимодействия 
порядок: порядок порядка порядке 
эвм: эвм 
сдать: сдал 
эс: эс 
добавить: добавить 
правило: правила правилами 
сообщение: сообщение 
претензия: претензий 
автоматический: автоматическая 
число: числе 
помощь: помощью 
видно: видно 
идентификация: идентификации 
пользователь: пользователя пользователем пользователь пользователей пользователю пользователях 
акцептовать: акцептовал 
вид: виде 
язык: языка язык 
направлять: направляет 
который: которые которой которых который 
пользовательский: пользовательского пользовательское пользовательским 
дзен: дзен 
мобильный: мобильное мобильного 
авторизация: авторизации авторизацию 
наш: нашим нашем 
момент: моменты 
определение: определение определения 
отказ: отказе 
поиск: поиск 
использовать: использовать использован 
выбрать: выбранном 
сайт: сайте 
код: кодом кода код 
карма: карма 
закон: законов 
верховный: верховного 
взгляд: взгляд 
работа: работы 
гражданка: гражданки 
лог: логами логах логи 
электронный: электронное электронный электронной электронная электронного электронным 
оформить: оформить оформлены 
далее: далее 
регистрационный: регистрационные 
настройка: настройка 
совпадать: совпадающие совпадает 
заявление: заявления 
профиль: профиль 
ознакомиться: ознакомился 
доказательство: доказательств доказательство доказательства 
подтверждать: подтверждает подтверждают 
фио: фио 
сформировать: сформирован 
жалоба: жалобы 
начало: начала 
номер: номера номеру номер 
представлять: представляют 
раздел: раздела раздел 
технический: технические техническая 
носитель: носителе 
старый: старую 
отправить: отправленным отправленный отправлен 
важный: важны 
кабинет: кабинете 
истец: истец истцу 
исковый: искового 
условие: условия 
подтверждаться: подтверждается 
дело: делам делу 
это: это 
договор: договора договор 
имущество: имущества имуществе 
требование: требований 
использование: использования использование использованием использовании 
судебный: судебной судебную 
поддержка: поддержка 
получить: получил полученный полученного 
пр: пр 
материал: материалом 
какой: какое каким какие 
телеграм: телеграм 
паспорт: паспортом 
потребоваться: потребуется 
хаба: хабы 
способ: способ 
рамка: рамках 
представить: представленных 
описание: описания описание 
заключить: заключен заключили 
подписание: подписания подписание подписании 
включить: включен 
указать: указаны 
образ: образом 
формироваться: формируется 
урегулирование: урегулирования 
определить: определить 
приёмка: приемки 
происходить: происходит 
форма: формы форме 
микулич: микулич 
качество: качестве 
исполнение: исполнением 
хотеть: хотим 
равнозначный: равнозначным 
следующий: следующим следующих 
тег: теги 
аренда: аренду аренде аренды 
теория: теории 
средство: средства 
прочтение: прочтение 
федеральный: федеральных 
положение: положениями 
соглашение: соглашением соглашения соглашение 
оформление: оформление оформления 
программа: программой 
бояться: бояться 
заключение: заключении заключению заключения 
апелляционный: апелляционной апелляционное 
механизм: механизма 
достоверный: достоверной 
выглядеть: выглядят выглядеть 
передача: передачи 
онлайн: онлайн 
рф: рф 
протоколирование: протоколирования 
рекомендовать: рекомендуем 
формулировка: формулировки 
заключать: заключать 
право: прав 
телефон: телефона 
законодательство: законодательство 
канал: канал 
обосновывать: обосновывают 
важно: важно 
принятие: принятии 
версия: версию 
предусмотреть: предусмотреть 
приём: приема 
повод: поводу 
рунетлекс: рунетлекса 
также: также 
бумажный: бумажном бумажных 
работать: работаете работала 
позиция: позицию 
соответствующий: соответствующие 
показывать: показывать 
реальный: реальный 
история: истории 
копирайт: копирайт 
федерация: федерации 
заметка: заметке 
сторона: сторонам сторон 
подтверждение: подтверждения подтверждение 
практически: практически 
хороший: лучшие 
получать: получает 
формирование: формирования 
вчера: вчера 
нарушение: нарушение 
спор: споров спорам спора 
вводить: вводит 
мина: мин 
текст: текст 
указанный: указанный 
создать: создавшего создан 
описывать: описывали 
такой: таким 
сутки: сутки 
авторизовать: авторизованным 
практика: практику 
содержать: содержащее 
администратор: администратор 
скан: скана 
совокупность: совокупности 
показываться: показывается 
кнопка: кнопку 
результат: результаты 
петрович: петровны 
соответствовать: соответствует 
достоверно: достоверно 
данные: данных 
предоставить: предоставленный предоставленным 
экономический: экономическим 
собственноручный: собственноручной 
рейтинг: рейтинг 
однократно: однократно 
доступ: доступ 
рассмотрение: рассмотрению 
иной: иной 
количество: количество 
скриншот: скриншот 
понимание: понимания 
введение: введения 
признаваться: признается 
личный: личном 
закладка: закладки 
текстовый: текстовые 
любой: любая любой 
похожий: похожие похожим 
вернуться: вернуться 
екатерина: екатерина 
себя: собой 
хабра: хабр 
проходить: проходит 
показать: покажем 
имя: имя 
дальнейший: дальнейшее 
храниться: хранится 
рекомендация: рекомендации 
российский: российской 
обновить: обновить 
файл: файлы 
связанный: связанный 
использоваться: используется 
время: время 
дать: данные 
просмотр: просмотров 
публикация: публикации 
осуществляться: осуществляется 
решение: решения 
формат: формат 
пример: примеров пример 
догорать: догорав 
мало: мало 
информация: информация 
активность: активности 
досудебный: досудебного 
иск: иске 
аналог: аналога 
регистрация: регистрации 
смс: смс 
объяснять: объяснять 
транспортный: транспортного 
случай: случае 
предоставлять: предоставлять 
принять: принял 
елена: елены 
судья: судьи 
коллегия: коллегии 
нажать: нажал 
другой: других 
лично: лично 
