учёный: ученых 
управлять: управляет 
микрофон: микрофоны микрофон микрофона микрофонов 
задача: задачи 
повторять: повторяя повторяющее повторяющий 
конденсаторный: конденсаторными конденсаторного конденсаторный 
пьезокристалл: пьезокристалл 
умный: умный 
самодельный: самодельные 
являться: является являются 
усиление: усиление усилению усиления усилением 
ан: ан 
поле: поле 
тишина: тишине 
атака: атаки 
шум: шумы шума шумов 
яндекс: яндекс 
выключатель: выключатели выключателя выключатель 
поскольку: поскольку 
напряжение: напряжение напряжения 
динамический: динамического динамический 
шотткать: шоттки 
автоматически: автоматически 
память: памяти 
будущее: будущем 
алюминиевый: алюминиевой 
соответственно: соответственно 
микроконтроллер: микроконтроллеров микроконтроллер микроконтроллера 
подходить: подходит 
повседневный: повседневные 
система: система 
анализ: анализа анализ 
представлять: представляет 
комментарий: комментарии 
закон: законом 
измерять: измеряет 
голос: голосов 
никель: никеля 
передавать: передает 
датчико: датчико 
написать: написал написать 
печатный: печатной 
сигнал: сигнал сигнала сигналов сигналы сигналом 
меню: меню 
собрат: собрата 
переменный: переменное переменным 
работать: работающий работает работать 
функция: функции 
радиолюбитель: радиолюбителей 
плата: плату платы плата плате 
достаточный: достаточным 
электромагнитный: электромагнитной 
пьезоэлектрик: пьезоэлектрике 
компаратор: компаратор 
сила: силу 
база: базе 
сенсорный: сенсорный 
чувствительный: чувствительной чувствителен 
изготовление: изготовления 
звуковой: звуковые звуковой 
провести: провёл провести 
должный: должна 
заслуга: заслугой 
сравнительный: сравнительный 
соотношение: соотношение 
тонкий: тончайшим тонкий тонкой 
смещать: смещать 
освобождение: освобождения 
добавить: добавить 
эдуард: эдуардом 
автоматический: автоматическая автоматической 
дом: дом 
программировать: программирует 
предшественник: предшественника 
нужно: нужно 
выбирать: выбираемое 
считать: считать 
удержание: удержания 
песочница: песочницы 
звук: звук звуке звуку звука 
исследование: исследование исследовании 
сравнение: сравнения сравнение 
конденсатор: конденсатора конденсатор 
язык: языка язык 
получаться: получается 
шаг: шаг 
электрический: электрическим электрический 
предел: предела 
схема: схема схему схем схемы 
дзен: дзен 
друг: другом 
отладочный: отладочная отладочную 
падать: падает падающий 
питание: питание 
группа: группы 
действовать: действует действуют 
физически: физически 
поиск: поиск 
собрать: собрал собрать 
нанести: нанесенным 
вход: вход 
карма: карма 
стрежень: стрежня 
написание: написание 
работа: работы 
управление: управления 
волна: волны 
свой: свои своей 
принцип: принцип принципу 
второй: второй вторая 
несколько: несколько 
низкий: низким 
настройка: настройка 
регулироваться: регулируется 
порог: порогом порога 
допустимый: допустимого 
датчик: датчика датчики датчик датчиков 
малошумящий: малошумящий 
одинаковый: одинаковым 
чувствительность: чувствительность 
стать: статей 
профиль: профиль 
зависимость: зависимости 
деформироваться: деформируется 
пьезоэлектрический: пьезоэлектрического пьезоэлектрический 
маленький: меньше 
параметр: параметрам 
заявить: заявленным заявленные 
мс: мс 
устройство: устройств устройство устройствами 
угольный: угольного 
качество: качества качестве 
начало: начала 
сопротивление: сопротивления 
делиться: делятся 
код: кода код 
лёгкий: легкой легкая 
старый: старую 
усилитель: усилителя усилитель усилители 
значительно: значительно 
использовать: используют использовал 
предназначить: предназначенная 
преобразование: преобразования 
видио: видио 
генератор: генератор 
инженер: инженером 
сжатие: сжатия 
уровень: уровня уровень уровнем 
высококачественный: высококачественный 
ленточка: ленточку 
фольга: фольги 
основный: основных 
это: это 
светодиод: светодиод 
доступный: доступен доступная 
заметить: заметить 
иметь: имеет 
компактный: компактном 
компонент: компонента компонент компоненты 
внешний: внешний 
использование: использования использованием 
итог: итог 
связанный: связанную 
провод: провода 
поддержка: поддержка поддержку 
температурный: температурный 
подвижный: подвижной 
диапазон: диапазон 
удобный: удобным 
весьма: весьма 
множество: множество 
мембрана: мембраны мембрана мембрану 
закрепить: закреплена закреплен 
год: году 
дать: данной данные 
очередь: очередь 
хаба: хабы 
проводник: проводник проводнику проводнике 
контактный: контактном 
ток: ток тока 
находить: нахожу 
структурировать: структурировать 
предложить: предложили 
каскад: каскад 
человек: человека 
вышеперечисленный: вышеперечисленных 
образ: образом 
явиться: явилось 
трехуровневый: трехуровневый 
восстановление: восстановления 
опора: опорой 
изначальный: изначальным 
золото: золота 
пользователь: пользователь 
площадь: площадь 
графика: графики графике 
обкладка: обкладка обкладок 
смещение: смещение смещения 
потенциометр: потенциометра потенциометр 
участие: участия 
регулировка: регулировки регулировкой регулировка 
такой: такое таким 
план: плане план 
мощность: мощностей 
тег: теги 
относительный: относительной 
сделать: сделаю 
ниже: ниже 
разделить: разделим 
прочтение: прочтение 
вычислительный: вычислительных 
толщина: толщиной 
поэтому: поэтому 
магнитный: магнитном 
американский: американским 
таблица: таблица таблицу 
первый: первых первом 
общий: общему 
фиксировать: фиксированное 
один: одна 
около: около 
колебаться: колеблется 
наводить: наводимое 
очень: очень 
изучить: изучил 
изобрести: изобретён 
важный: важный 
данный: данном данный 
третий: третий 
итак: итак 
резистивный: резистивный 
появляться: появляется 
тестирование: тестирования 
превосходящий: превосходящий 
хлопковый: хлопковый хлопкового хлопковые 
вента: венте 
качественный: качественнее качественного 
версия: версию 
установить: установлено 
перемещаться: перемещается 
программный: программный 
хлопок: хлопка 
понять: понять 
характеристика: характеристик характеристикам характеристики 
предлагать: предлагает 
постоянный: постоянного 
индукция: индукции индукцией 
фильтровать: фильтрует 
также: также 
пластик: пластик 
делать: делает 
который: который которого 
выходной: выходной выходного 
способный: способных 
составить: составил составить 
история: истории 
большинство: большинство 
тип: тип типов 
библиотека: библиотеки библиотека 
ару: ару 
линейность: линейности 
показать: показал 
достаточно: достаточно 
оказаться: оказался 
конструкция: конструкция 
хороший: лучшие 
рассчитать: рассчитано 
расширить: расширенный 
тонкость: тонкости 
индуцироваться: индуцируется 
вальтер: вальтера 
посылать: посылает 
макетный: макетная 
немецкий: немецких 
действие: действием 
шуметь: шумит 
присутствие: присутствием 
громкий: громком 
мина: мин 
традиционно: традиционно 
эрлах: эрлаха 
недорогой: недорогой 
предусилитель: предусилитель 
сутки: сутки 
получить: полученное полученные 
проект: проекта 
переключать: переключает 
соответствие: соответствии 
частотный: частотных 
отправлять: отправляет 
гофрированный: гофрированную 
дб: дб 
изменение: изменения изменение 
нужный: нужен 
коэффициент: коэффициент 
цифровой: цифровой 
проанализировать: проанализировать 
слой: слоем 
выше: выше 
электроёмкость: электроёмкости 
данные: данных 
стабильно: стабильно 
занять: занял 
отследить: отследить 
рейтинг: рейтинг 
движение: движения 
модуль: модуля 
технический: техническая 
ма: ма 
посмотреть: посмотрев 
количество: количество 
решать: решать 
потреблять: потребляемый 
мкм: мкм 
довольно: довольно 
электретный: электретные 
дальнейший: дальнейшего 
закладка: закладки 
простой: простой 
устроенный: устроен 
последний: последнее 
программирование: программирование 
рождение: рождение 
делитель: делитель 
наличие: наличия 
похожий: похожие 
изучение: изучение 
вернуться: вернуться 
сдать: сданных 
домашний: домашних 
себя: собой 
активироваться: активируется 
пластиковый: пластиковой 
счёт: счёт 
хабра: хабр 
сложность: сложности 
хватать: хватает 
регулировать: регулируя 
обновить: обновить 
разобраться: разобраться 
дисплей: дисплей 
использоваться: используется 
два: две 
время: время 
значит: значит 
просмотр: просмотров 
публикация: публикации 
популярный: популярны 
так: т 
выступать: выступает 
тема: темой 
контролировать: контролировать 
производитель: производителем 
вид: виды 
мк: мк 
расположить: расположили 
аналоговый: аналоговый 
часть: части 
пакет: пакет 
усиливать: усиливает 
описание: описание 
значение: значением 
гервин: гервина 
колебание: колебаний колебания 
вывод: выводах 
определённый: определённые 
стержень: стержнем 
блок: блок 
микросхема: микросхема 
разрешение: разрешение 
заводский: заводским 
приводить: приводят 
электронный: электронными 
случай: случае 
прошивка: прошивке 
корпус: корпусе 
подходящий: подходящим 
выход: выход 
новый: новый 
мара: мар 
решить: решил 
передний: передней 
неподвижно: неподвижно 
мочь: можете 
