ваш: ваш вашими 
иностранный: иностранных иностранные 
удалить: удалена 
пространство: пространство пространству пространства пространств 
оставить: оставить 
распаковка: распаковки 
оплачивать: оплачивает 
импортировать: импортировать 
сервис: сервиса 
поле: поле 
один: одного 
яндекс: яндекс 
особенность: особенность 
отдельный: отдельную отдельном 
скопировать: скопируйте 
право: права 
упоминаться: упоминается 
канал: каналов 
терпение: терпением 
экспорт: экспортом экспорт экспорта 
комментарий: комментарии комментариях 
год: год 
голос: голосов 
почта: почтами почты почт 
вывести: выведен 
написать: написал 
выполниться: выполнились 
меню: меню 
оказывать: оказывать 
часть: часть 
конкретно: конкретно 
конец: конце 
базовый: базовый базовым базовой 
полный: полную полного полном полные 
добавить: добавить добавит 
найти: найдите найти 
текстовый: текстовом 
сам: самом 
такой: такие 
нужно: нужно 
граница: границы 
поступить: поступят 
сделать: сделать 
язык: языка язык 
который: которые который которую 
коробочный: коробочной 
находиться: находится 
рабочий: рабочего рабочее рабочие 
дзен: дзен 
тариф: тарифе тарифа тарифов 
возможность: возможность возможности 
подписка: подписку 
итог: итоге 
прекращение: прекращении 
гарантия: гарантий 
переписка: переписку переписок переписки 
поиск: поиск 
использовать: использовать 
подходящий: подходящего 
второй: втором второй вторая 
включение: включения 
карма: карма 
заменить: заменить 
выгрузить: выгрузить 
свой: свои 
быть: будете будем будут 
переезжать: переезжать 
пачка: пачка 
остаться: остаться 
российский: российское российские 
предоставить: предоставьте 
файл: файлов файлу файла файлы файл 
мессенджер: мессенджерах мессенджер мессенджеры мессенджеров 
скачать: скачать 
настройка: настройка 
выбор: выбором 
удобно: удобно 
профиль: профиль 
программа: программу 
правильно: правильно 
прошлый: прошлых 
тот: тех 
подробный: подробная подробные 
начало: начала начале 
отличаться: отличаться 
инструкция: инструкция инструкцией инструкции 
весь: вся 
старый: старую 
использование: использованию использованием 
подобный: подобные 
заработать: заработало 
решить: решили решить 
чат: чатов 
учитывать: учитывает учитывайте 
россия: россии 
вернуться: вернитесь вернуться 
указать: указали указаны указать 
писать: пишут 
архив: архивом архивов архив архиву архива 
это: это этим 
ознакомиться: ознакомиться 
запрос: запрос запросов 
команда: команды команду команда 
заблокировать: заблокирует 
работа: работу 
поддержка: поддержка поддержку поддержки 
знание: знаний 
хранить: хранить 
первый: первая первый первом 
открытый: открытых 
хаба: хабы 
должный: должен 
бесплатный: бесплатном 
ввести: ввести 
близкий: ближе 
туториал: туториал 
отношение: отношений 
февраль: февраля 
бизнес: бизнеса 
токен: токенами токен 
пролистать: пролистайте 
разослать: разослал 
польза: пользы 
письмо: письма письме 
перенести: перенести 
тег: теги 
объявить: объявил 
ниже: ниже 
корпоративный: корпоративный 
уровень: уровень 
рада: рады 
слово: слову 
прочтение: прочтение 
например: например 
шаг: шагах 
поэтому: поэтому 
разный: разные разных 
делать: делать 
продолжить: продолжить 
предупреждать: предупреждает 
сильно: сильно 
формат: формате 
левый: левом 
пользователь: пользователей пользователями 
путь: путь 
очень: очень 
запастись: запастись 
база: базой 
дополнение: дополнения 
каждый: каждого 
прекратить: прекратит 
предлагать: предлагают 
получить: получить получили получите 
правильный: правильной 
выбрать: выберите 
техника: технике 
день: день дней 
рекомендовать: рекомендуем 
случаться: случались 
просто: просто 
проходить: проходят 
импорт: импорт импорта 
блокировка: блокировке блокировки 
положить: положить 
прислать: пришли 
назад: назад 
версия: версию версии 
кто: кому 
редактор: редакторе 
распаковать: распакуйте распакованный 
вложение: вложений вложения 
запустить: запустите запустить запущена 
также: также 
поработать: поработать 
история: истории 
расписать: расписали 
тип: тип типы 
предупреждение: предупреждений 
комментировать: комментировать 
мочь: могли можете 
верный: верный 
создавать: создавали 
хороший: лучшие 
владелец: владельцам 
бот: бота 
сайт: сайт 
выгрузка: выгрузке выгрузку выгрузкой выгрузки 
мина: мин 
нажать: нажмите 
потерять: потерять 
работать: работает 
сутки: сутки 
современный: современный 
трепет: трепетом 
прописывать: прописывать 
правило: правило 
перейти: перейдите 
туда: туда 
доступно: доступно 
перевезти: перевезти 
рейтинг: рейтинг 
предел: пределами 
любой: любые 
необходимый: необходимом 
другой: другие другое 
доступ: доступ 
далёкий: дальше 
технический: техническая 
больший: большим 
количество: количество 
отключение: отключении 
приложение: приложению 
дополнительно: дополнительно 
список: списке списку 
папка: папку папка папке 
закладка: закладки 
простой: простой 
название: названиями название 
похожий: похожие 
импортозамещение: импортозамещение 
подробно: подробно 
хабра: хабр 
сложность: сложности 
наверх: наверх 
март: марта 
обновить: обновить 
разобраться: разобраться 
сохранить: сохранить 
время: время 
дать: данные 
просмотр: просмотров 
публикация: публикации 
никакой: никаких 
решение: решения 
электронный: электронные 
так: т 
оплата: оплаты 
аккаунт: аккаунтов 
информация: информация 
х: х 
загрузить: загрузить 
они: ними 
ограничение: ограничения 
рассказывать: рассказываем 
выглядеть: выглядеть 
относиться: относится 
пример: пример 
мара: мар 
нужный: нужный 
назвать: назвать 
