санкция: санкций 
весь: весь вся всем 
материал: материалов материалы 
мочь: могут можете 
управление: управление 
принимать: принимают 
разный: разную 
интерес: интересы 
общий: общего общий 
день: дня 
заказ: заказе заказа заказ 
большой: большой велик 
обращать: обращали 
вес: весом вес 
качество: качеством качества качество 
партнёр: партнером 
штучный: штучные 
любой: любого любых 
зависимый: зависимо 
продажа: продаже 
карго: карго 
уточнять: уточняйте 
договор: договоре 
выйти: выйти вышла 
внимание: внимание 
давно: давно 
допустить: допустим 
присылать: присылают 
яндекс: яндекс 
отличаться: отличаются 
нужный: нужны нужные 
получиться: получится 
автоматически: автоматически 
коммерческий: коммерческими 
среднее: среднем 
находиться: находился 
сам: самого 
участвовать: участвовать 
система: система 
отправка: отправки отправку 
фотография: фотографий 
комментарий: комментарии 
приготовиться: приготовьтесь 
кг: кг 
организовать: организовать 
голос: голосов 
случай: случаи случаях случае 
тариф: тарифах 
визуальный: визуальную визуальный 
гонконг: гонконге 
прийти: пришло пришел 
удача: удачи 
меню: меню 
китаец: китайцы 
тот: тому тех той 
должный: должны 
документ: документах документы документов 
помимо: помимо 
поставщик: поставщиками поставщик поставщика поставщиков 
преимущественно: преимущественно 
рассчитываться: рассчитывается 
подбирать: подбирают 
далее: д далее 
сервис: сервисов сервис сервисом 
судить: судя 
аккуратный: аккуратнее 
китай: китаем китая китай китаю 
размер: размер 
зарегистрироваться: зарегистрироваться 
желаемый: желаемой 
пробный: пробную 
авто: авто 
бережно: бережно 
знание: знанием 
закуп: закуп 
учитывать: учитывать 
заполнение: заполнение 
южный: южной 
склад: склад складе 
забавный: забавный 
свой: свой 
разрешительный: разрешительные 
добавить: добавить 
год: лет году года 
неклиентоориентировать: неклиентоориентированная 
юлия: юлия 
объём: объемом объём 
коэффициент: коэффициенты коэффициент коэффициенте 
зависеть: зависит 
собрать: собрала собрана собрать 
консолидация: консолидации 
нужно: нужно 
фото: фото 
рисковать: рискуете 
компенсация: компенсацию 
крупный: крупную крупных крупные 
открытие: открытия 
маркетплейс: маркетплейсы маркетплейсов 
отправить: отправить отправят отправил 
сделать: сделать 
язык: языка язык 
хранение: хранения 
который: которые которая который которую котором 
обращаться: обращалась 
течение: течении течение 
дзен: дзен 
административный: административных 
выкуп: выкупа выкупу выкуп 
категория: категории 
отзыв: отзывам отзыв 
стоимость: стоимость стоимости 
делать: делают делает 
собственно: собственно 
мой: моем 
гипотеза: гипотезу 
включить: включены включен 
повреждение: повреждении 
оплата: оплатой оплату 
поиск: поиск 
доставлять: доставляет доставлять доставляют 
товар: товары товара товар товаров товарами 
сайт: сайте 
китайский: китайских китайскими китайская китайским китайские 
карма: карма 
обувь: обувь 
взгляд: взгляд 
редкость: редкость 
русский: русского 
работа: работы работа 
скинуть: скинуть 
отчёт: отчет 
сообщить: сообщит 
юр: юр 
доплачивать: доплачивать 
юля: юля 
несколько: несколько нескольких 
российский: российское 
небольшой: небольшую небольшой 
техподдержка: техподдержка 
импорт: импорте импорт 
недавно: недавно 
счёт: счета 
цена: цену цене 
настройка: настройка 
привет: привет 
необходимо: необходимо 
заказывать: заказываете заказывать заказывал 
удобно: удобно 
привезти: привезти 
профиль: профиль 
расторопный: расторопны 
гуаньчжоу: гуаньчжоу 
агентство: агентство 
внутренний: внутренний 
детальный: детальную детальная 
кравцов: кравцова 
европа: европы 
номер: номера номер 
округ: округах 
сторона: стороне 
партия: партию партии 
лекарство: лекарства 
проверять: проверяйте проверяет проверяют 
привозить: привозят привозить 
облегчить: облегчит 
мониторит: мониторите 
платёж: платежей 
параллельный: параллельный 
старый: старую 
сертификат: сертификаты 
сеть: сети 
клиентоориентировать: клиентоориентированные 
ключ: ключ 
раз: раза 
значиться: значится 
запас: запасов 
контрагент: контрагентов 
кабинет: кабинете кабинет 
территориально: территориально 
юань: юаней юаня 
примечательный: примечательны 
оптовый: оптовыми 
лот: лот 
дефект: дефектом 
многий: многих 
розница: розницей 
заказать: заказали заказать 
авиа: авиа 
покупать: покупаете 
выдать: выдали 
это: это этим 
заноситься: заносится 
габарит: габарит 
доплатить: доплатите 
задача: задачу 
самый: самых 
тг: тг 
получить: получен получить 
итог: итог 
поддержка: поддержка 
обзор: обзор 
сверять: сверяйте 
пр: пр 
повышать: повышающем повышающие повышающий 
иу: иу 
тестовый: тестовые 
закрываться: закрываться 
ссылка: ссылку ссылка 
выкупить: выкупят выкуплен выкупили выкупить 
юрлицо: юрлицами юрлицо 
снизиться: снизится 
скидываться: скидываются 
очередь: очередь 
хаба: хабы 
выезд: выезды 
указать: указана указать указано 
выкупать: выкупают выкупать выкупает 
прекрасный: прекрасные 
итоговый: итоговой 
прописываться: прописываться 
заниматься: занимается 
быть: будьте будут 
менеджер: менеджеров менеджер менеджеры 
отказаться: откажетесь 
время: времени время 
пользователь: пользователь 
вплоть: вплоть 
пользование: пользования 
сотрудник: сотрудники 
добавлять: добавляют 
упаковать: упаковать 
таможня: таможне 
сумма: сумму сумма суммы 
поставка: поставки поставку 
доп: доп 
составить: составят 
задержка: задержки 
узнать: узнаете узнать 
личный: личный личном личного 
больший: большая большую 
оказывать: оказывает оказывают 
магазин: магазинов 
учёт: учета 
срок: сроках срок 
чат: чат 
услуга: услуг услуги услугами 
прислать: пришлет прислали 
быстрый: быстрая быстрее 
тег: теги 
оформление: оформлением 
знать: знает 
цикл: цикла 
везде: везде 
ниже: ниже 
рабочий: рабочими 
дата: датой 
прочтение: прочтение 
выплатить: выплатят 
месяц: месяца месяцев 
например: например 
м: м 
предварительный: предварительная 
поэтому: поэтому 
рассчитать: рассчитать рассчитает 
компания: компании компания компаний компанией 
смотреть: смотрела 
особенно: особенно 
плохой: плохого 
сильно: сильно 
первый: первый первую 
выгодный: выгодных 
расчёт: расчета расчет 
проверка: проверки проверку проверка 
встать: встал 
перевод: переводу 
один: одна одному 
единичный: единичных 
способ: способы 
очень: очень 
выдаваться: выдаются 
кстати: кстати 
полный: полного 
важный: важный 
закончиться: закончился 
каждый: каждого каждый каждую 
данные: данными 
плюс: плюсы 
таиланд: таиланду таиланда таиландом 
фотоотчёт: фотоотчет 
фабрика: фабрика фабрику фабрики 
свыше: свыше 
оттуда: оттуда 
рф: рф 
случайность: случайности 
сколько: сколько 
деньга: деньги денег 
отстаивать: отстаивать 
продавец: продавцов 
просто: просто 
спортивный: спортивные 
важно: важно 
тест: теста 
адрес: адресом 
казаться: кажется 
закупка: закупки 
поехать: поедет 
версия: версию 
россия: россию 
доставить: доставить доставили 
сверху: сверху 
ваш: ваши 
лицо: лицами 
сутки: суток сутки 
сопутствовать: сопутствующие 
помочь: поможет помогут 
закупить: закупить 
пользоваться: пользуется 
производитель: производителя 
также: также 
старинка: старинке 
работать: работаете работают работать 
проблема: проблемы 
упаковка: упаковка 
рынок: рынке 
тендер: тендерах 
мы: нам 
история: истории 
запрос: запросу 
бизнес: бизнес 
заполнить: заполнить 
ввоз: ввоз 
некоторый: некоторые 
ссылаться: ссылаясь 
краска: краски 
достаточно: достаточно 
консультировать: консультируют 
полиграфический: полиграфических 
хороший: лучшие 
клиентка: клиентка 
оказаться: оказалось 
текстиль: текстиль 
искать: искал искать 
переписка: переписки 
бот: бот 
оставаться: оставалось 
вопрос: вопрос 
вводить: вводит 
дело: дело 
метод: методом 
мина: мин 
индивидуально: индивидуально 
риск: риск 
посредник: посредника посредник 
скрин: скрин 
смочь: сможете 
спор: спора 
другой: другая другие других 
доставка: доставки доставкой доставка 
минимальный: минимальная минимальный 
таможенный: таможенных таможенную 
руководить: руковожу 
иначе: иначе 
выбор: выборе 
отписать: отпишут 
продаваться: продаваться 
подвиснуть: подвиснуть 
найти: нашла 
брак: брак 
убедиться: убедиться 
отбираться: отбирается 
выше: выше 
низкий: низких 
удобный: удобный 
помогать: помогает помогают 
делиться: делилась 
декларация: деклараций 
зарегистрировать: зарегистрирована 
скидка: скидками 
примерно: примерно 
оптом: оптом 
возить: возят 
хотеть: хотите 
рейтинг: рейтинг 
составлять: составляет 
оплатить: оплатить 
два: двух 
платформа: платформа 
трек: трек 
зарубежный: зарубежные 
технический: техническая 
сложно: сложно 
запретить: запретили 
отдельно: отдельно 
условие: условиях 
самостоятельно: самостоятельно 
выяснить: выяснить 
количество: количество 
подборка: подборку 
мелкий: мелким 
такой: такая 
пункт: пункт 
груз: грузами 
закладка: закладки 
опыт: опытом 
брать: берут 
конечный: конечная 
сталкиваться: сталкиваюсь 
площадка: площадке 
похожий: похожие 
вернуться: вернуться 
модель: модели 
бюджет: бюджета 
многие: многие 
измерить: измерить 
перевести: перевести 
хабра: хабр 
впервые: впервые 
опубликовать: опубликовала 
характеристика: характеристики 
сложность: сложности 
долго: долго 
сразу: сразу 
официальный: официальных 
бывать: бывают 
обновить: обновить 
страховка: страховка 
договориться: договориться 
таблица: таблицами 
проверить: проверить 
оплачиваться: оплачиваются 
заранее: заранее 
средний: средним 
корея: кореей 
просмотр: просмотров 
заявка: заявку 
публикация: публикации 
обрешётка: обрешетки 
курс: курсов 
покупатель: покупателями 
государственный: государственных 
отличный: отличная 
образец: образцы 
информация: информация 
пакет: пакет 
загрузить: загрузить 
описание: описанием 
упаковочный: упаковочных 
производство: производству 
руб: руб 
переговоры: переговорами 
белый: белую 
япония: японией 
посетить: посетят 
комиссия: комиссия 
гараж: гараж 
апрель: апреле 
вбить: вбить 
отвечать: отвечают 
подробный: подробным 
быстро: быстро 
пример: пример 
кусаться: кусается 
нюанс: нюансы 
мара: мар 
пара: пару 
возникать: возникают 
шанс: шанс 
пятый: пятый 
минус: минусы 
