процесс: процессы процессе процесс процессах 
мочь: могут можем 
управление: управление 
клиент: клиентам клиент клиентами клиента клиентов клиенты 
брендовый: брендовых брендовый 
напоминалка: напоминалку 
придумать: придумать 
планировать: планирует 
забавный: забавная 
конкурент: конкурент 
верстальщик: верстальщикам 
специалист: специалистам 
доставаться: достается 
видеть: вижу 
фух: фух 
поделать: поделать 
большой: большой 
оставить: оставить оставили 
партнёр: партнером партнеру партнеров партнеры партнера партнер 
готовый: готовых готовые 
понять: поняли 
продавать: продавали продаем 
плохой: хуже 
выручка: выручки выручку выручкой выручке 
гугл: гугл 
доля: доля долю 
друг: друга другу друг 
платный: платным 
работать: работали работает работать 
база: базы базу база 
уйти: ушел уйдут ушли 
яндекс: яндекс 
нанять: нанял 
вести: вела 
занимать: занимать занимал 
агентство: агентстве агентство агентствами агентства 
нагнать: нагнать 
компания: компаниям компании компаний компанией 
участвовать: участвовать 
сам: самого самом сами 
человек: человеком людей люди 
общий: общей общие общими общее 
значение: значения 
партнёрство: партнерство 
комментарий: комментарии комментариях 
организовать: организовать 
бренд: бренда бренд бренды брендов 
нафиг: нафиг 
год: год году года годами 
подозревать: подозреваю 
голос: голосов 
предложение: предложениями 
хотеть: хотел 
продукт: продуктом 
прибыль: прибыли прибыль 
перечитать: перечитал 
удача: удачи 
никто: никого никто 
умножить: умножили 
меню: меню 
валовый: валовой валовую 
разный: разная разными 
должный: должны должен 
всякий: всякие 
маркетинг: маркетинг маркетинга маркетингом 
который: которыми которые которым которая которых который которому 
период: период 
разойтись: разошлись разойтись 
команда: командой команды команду команде команд 
объединить: объединили 
часть: часть частью части 
заплатить: заплатить 
предоплата: предоплату 
конкретно: конкретно 
крутой: крутым крутого крутых 
ретроспектива: ретроспективу ретроспективы 
приходить: приходили приходят 
потратить: потратить 
домен: домен 
коммент: комментах 
другой: другим другое 
опередить: опередить 
верить: верим 
общаться: общались 
вдвоём: вдвоем 
отделить: отделить 
дело: деле дела 
свой: свой свои своем свое своим 
кейс: кейсы кейсами кейс кейсов 
добавить: добавить добавили 
помогать: помогаю 
принять: примут 
отдать: отдал 
декабрь: декабрь 
адрес: адреса 
появиться: появился 
использовать: использовали использовать 
подписчик: подписчиков подписчиками подписчикам 
похожий: похожих похожие 
такой: такие такого 
кто: кого 
оценка: оценке оценку 
запретить: запретила 
сейзло: сейзла 
заняться: заняться 
сайт: сайтами сайте сайт 
интересно: интересно 
считать: считать считали считаю 
образоваться: образовавшаяся 
компенсация: компенсацию 
смена: смены 
ранний: раньше 
получать: получаем 
отказаться: отказался 
простой: проще простой 
предупредить: предупредили 
сделать: сделать сделали сделаем 
усилие: усилия 
аж: аж 
язык: языка язык 
получаться: получается получалось 
этот: этими 
переходить: переходят 
себестоимость: себестоимостью 
учесть: учесть учли 
внутренний: внутренние внутренними 
дзен: дзен 
думать: думают думаю думать 
какой: какую 
каждый: каждому каждым каждого каждый каждая 
итог: итоге 
развивать: развивали развивать 
автор: авторы авторам авторов 
наш: нашим нашего наш нашей нашем 
создать: создал 
железно: железно 
сейлз: сейлз 
стоимость: стоимость стоимости 
курс: курс курсы курсов 
тесновато: тесновато 
сервер: сервер 
старый: старым старой старую старый старых старом старые 
переписка: переписку 
документ: документы 
поиск: поиск 
тот: те 
одинаковый: одинаковыми 
цивилизованно: цивилизованно 
заодно: заодно 
выгрузить: выгрузил 
смущать: смущать 
соцсеть: соцсетей соцсетях 
карма: карма 
передавать: передавал передавали передавать 
новый: новом нового новыми новые новых новое новый новой 
рубль: рублей 
неучтённый: неучтенных 
работа: работы работу работа работе 
обучение: обучения 
поставить: поставил 
прежний: прежний 
делиться: делиться 
текущий: текущих текущий текущие текущим 
поделить: поделили поделить 
несколько: несколько 
далее: далее 
разделить: разделили 
память: память 
трафик: трафик трафиком 
возвращать: возвращаем 
управлять: управляли 
поверхностно: поверхностно 
настройка: настройка 
решение: решений решение 
привет: привет 
ждать: ждет 
входить: входят 
два: двумя 
стать: статей стал стало стали 
разница: разницу 
договорённость: договоренности 
навстречу: навстречу 
профиль: профиль 
рентабельность: рентабельность 
ситуация: ситуация ситуацию 
касса: кассы 
плохо: плохо 
долгосрочный: долгосрочный 
статья: статьями статьи 
остаться: осталось остался остались 
норма: норм 
взнос: взносы 
дели: дели 
раздел: раздела 
продакт: продакт 
канал: каналы канал канале 
ноль: ноль 
дизайнер: дизайнерам 
рабочий: рабочим 
сохраниться: сохранится 
драйвер: драйвер 
задонатить: задонатить 
продажа: продажи продажам продажу продаж продажами 
успеть: успели успел 
значительно: значительно 
обрасти: обрастем 
финансироваться: финансировались 
половина: половину 
решить: решили 
разделение: разделение разделения разделению 
поток: потоки 
проект: проектами проекту проект проектам проекта проектов проекты 
ведение: ведением 
подрядчик: подрядчикам 
знать: знаю 
договориться: договорились 
пост: посты постами 
вызвать: вызовет 
уходить: уходят 
повод: повод 
условие: условия 
контент: контент 
штука: штуки 
календарь: календаре 
искать: ищут искать 
посчитать: посчитать посчитали 
это: это этим 
рассчёт: рассчетах 
множество: множеством 
доступный: доступен 
страница: страницы страницах 
иметь: имеет иметь 
эфир: эфире 
будущий: будущих 
сохранить: сохранили сохранил 
исполнительный: исполнительного исполнительный 
поддержка: поддержка 
аудитория: аудиторию 
рассказать: расскажите 
чертовщина: чертовщина 
вырасти: вырос 
средний: среднюю средние 
спросить: спросить спросили 
маркетолог: маркетолог 
один: одном одно 
передаться: передались 
телеграм: телеграм 
опыт: опыт опыте 
лёша: лешей 
время: временем времени время 
крупный: крупных 
почитать: почитать 
потребоваться: потребуется 
очередь: очередь 
никакой: никакие 
хаба: хабы 
способ: способ 
руководство: руководства 
расходиться: расходимся 
публиковать: публиковать 
существующий: существующие 
предложить: предложили 
месяц: месяц месяцев 
опубликовать: опубликовали 
получиться: получилось 
подряд: подряде 
скопировать: скопировал 
вопрос: вопросов 
лида: лида лид 
против: против 
внутри: внутри 
запрос: запросов 
забрать: забрал 
аккаунт: аккаунты 
будущее: будущее 
обратно: обратно 
прикинуть: прикинули 
делёжка: дележки 
единственный: единственный 
список: список списка 
название: названия названиями название 
бизнес: бизнеса бизнес 
целиком: целиком 
происходить: происходит 
приходиться: приходится 
проблема: проблем проблемы 
первый: первое первый первую 
дыра: дыра 
владелец: владельца 
послать: послали пошли 
больший: большая большую 
изучить: изучить 
обращаться: обращались обращаются 
сообщество: сообщества сообществ 
задача: задачами 
услуга: услуг услуги 
течение: течение 
снова: снова 
идти: идет 
тег: теги 
тендер: тендеров 
рассказывать: рассказываю рассказывать 
делимый: делим 
вниз: вниз 
ребята: ребятам 
уровень: уровень 
прямой: прямом 
офис: офис 
млн: млн 
слово: слову 
прочтение: прочтение 
рыба: рыба 
сотрудник: сотрудников сотрудникам 
оно: оно 
куча: кучу 
поэтому: поэтому 
неделя: недель 
объяснить: объяснили 
делать: делать 
кусочек: кусочек 
сильно: сильно 
обсуждать: обсуждали обсуждать 
правильный: правильнее 
поровну: поровну 
попроектный: попроектно 
подготовить: подготовил 
счастие: счастью 
лишаться: лишаться 
пройти: прошло прошли 
тильда: тильде 
разругаться: разругались 
сервис: сервис 
около: около 
качество: качество 
просесть: просядет просело просесть 
очень: очень 
начать: начали 
рад: рад 
важный: важный 
сарафанк: сарафанки 
закостенеть: закостеневшие 
выкупать: выкупать выкупает 
бывать: бывает 
перебивать: перебивали 
оттуда: оттуда 
удалять: удалять 
пересчитывать: пересчитывать 
бухгалтерия: бухгалтерию бухгалтерия 
онлайн: онлайн 
насколько: насколько 
обязательство: обязательств обязательства 
устроить: устроил 
сколько: сколько 
истёмный: истемный 
выполнить: выполненные 
архив: архив 
поубивать: поубивать 
деньга: деньги денег 
пополам: пополам 
соглашение: соглашению 
просто: просто 
портфолио: портфолио 
статус: статус 
таблица: таблицу 
нормально: нормально 
имейл: имейл 
перевес: перевес 
напоминать: напоминать 
юкасса: юкассы 
оценить: оценили оценить 
назад: назад 
казаться: кажется казался казалось 
затем: затем 
версия: версию 
странно: странно 
измениться: изменятся 
ваш: ваши 
фрилансер: фрилансерами 
сходиться: сходятся 
справедливый: справедливым справедливую 
школа: школе 
насчитать: насчитал 
передать: передали 
саботировать: саботировать 
возникнуть: возникло 
отзыв: отзывами отзывов 
налог: налоги 
счёт: счетах счетам 
менеджер: менеджер 
разовый: разовый 
поработать: поработать 
зато: зато 
рынок: рынке 
запороть: запороли 
менять: менял 
равный: равные 
плюс: плюс 
уточнить: уточнить 
обойтись: обошлось 
мы: нам нами 
история: истории историю 
дублирование: дублирование 
право: право 
выписать: выписали 
реально: реально 
оставаться: остается остаются 
текст: текстами 
собрать: собрали 
закрыться: закрылась 
захотеть: захотел 
вариант: варианты вариант 
хороший: лучшие лучшими 
ник: ником 
актив: активов активы 
случиться: случилась 
прийтись: пришлось 
магнит: магниты 
недавний: недавнего 
информация: информацию информации 
свести: свели 
контракт: контракт 
одновременно: одновременно 
согласовать: согласовали 
забирать: забирает забирать 
оба: оба обоих 
мина: мин 
деление: делении 
делить: делить 
иллюстратор: иллюстраторов 
брать: брали 
суть: сути 
пара: пара пару 
сутки: сутки 
клиентский: клиентскими 
совместный: совместным 
столько: столько 
инст: инста 
продолжать: продолжает 
запустить: запустили 
выходить: выходит 
весь: всем 
сильный: сильный 
интересный: интересным 
коэффициент: коэффициент 
лид: лидов 
вакансия: вакансии вакансий 
редактор: редакторы 
январь: январе 
павел: павел 
свободный: свободные 
быть: будем будут 
потерянный: потерянную 
молян: молянов 
занять: занял 
редакция: редакции 
ютуба: ютуб 
сюда: сюда 
директор: директора директор 
обманывать: обманывать 
находиться: находилось 
дойти: дошли 
наслать: нашли 
табличка: таблички 
немного: немного 
генерировать: генерировала 
вроде: вроде 
рейтинг: рейтинг 
получить: получили 
обойти: обойти 
вконтакте: вконтакте 
далёкий: дальше 
доступ: доступ 
движение: движения 
невообразимый: невообразимый 
улучшить: улучшить 
технический: техническая 
второй: второго 
составить: составили 
тянуть: тянуть 
отдельно: отдельно 
поменяться: поменяется 
количество: количество 
пока: пока 
пазл: пазл 
стабильность: стабильности 
объективный: объективный 
переход: перехода переходов 
найти: найти 
оборот: оборот 
заниматься: занимался 
одеяло: одеяло 
бэк: бэк 
оптимизировать: оптимизировать 
довольно: довольно 
неплохо: неплохо 
закладка: закладки 
ошибка: ошибок 
неопределённость: неопределенности 
описать: описали 
паша: паша 
вернуться: вернуться 
модель: модели 
промостраница: промостраницах 
многие: многие 
поломать: поломать 
привлечение: привлечения 
удачно: удачно 
личный: личные 
сказать: сказал 
всплыть: всплыть 
хабра: хабр 
реклама: рекламой 
таки: таки 
поломаться: поломались 
аутсорс: аутсорс 
сложность: сложности 
долго: долго 
момент: момент 
сразу: сразу 
цена: цене 
бесконечно: бесконечно 
выплачивать: выплачивает 
обновить: обновить 
мнение: мнения 
файл: файлы 
дать: данные 
сумма: суммы 
написать: напишите 
немало: немало 
аналитик: аналитик 
глава: главе 
проверить: проверенных 
надёжность: надежности 
основа: основе 
просмотр: просмотров 
публикация: публикации 
главред: главредом 
писать: писать 
хаос: хаос 
тысяча: тысяч 
сложный: сложнее 
аналогичный: аналогичные 
всячески: всячески 
они: ними 
выиграть: выиграем 
упоминание: упоминаний 
сотрудничать: сотрудничать 
активный: активнее 
перемножить: перемножили 
наоборот: наоборот 
общение: общения 
размещать: размещает 
предлагать: предлагали 
разрешение: разрешение 
спор: споры 
рост: роста 
пожелать: пожелали 
складываться: складывался 
мобилизация: мобилизация 
обида: обиде 
случай: случае 
рожковый: рожковым 
быстро: быстро 
блог: блогов 
создание: создания 
очевидный: очевидно 
комиссия: комиссию 
логин: логин 
отличный: отличный 
мара: мар 
созвониться: созвонились 
сложить: сложили 
руководитель: руководитель 
вместе: вместе 
расклад: расклада 
вообще: вообще 
сравняться: сравняемся 
учёт: учетом 
сначала: сначала 
лично: лично 
к: ко 
