весь: весь 
мочь: могут можете 
структура: структура 
забирать: забираем забирать 
пагинация: пагинация пагинации 
удобство: удобства 
бд: бд 
поле: поле 
действие: действия 
соответственный: соответственная 
база: базы базу базой 
внимание: внимание 
яндекс: яндекс 
ошибка: ошибку ошибке 
получиться: получится получилось 
значение: значение значения значении значением 
скрываться: скрываются 
соответственно: соответственно 
сохранить: сохраним сохранить 
клавиша: клавиш 
строка: строке строк 
один: одну 
комментарий: комментарии 
голос: голосов 
столбец: столбец столбца 
перейти: перейти 
хотеть: хотел 
страница: страницу странице страницы страницах страниц 
нажатие: нажатие нажатии 
воспользоваться: воспользуемся 
меню: меню 
уникальный: уникальные 
сам: саму 
переменный: переменные переменных 
ботафазер: ботафазера 
пагинировать: пагинировать 
перезапускать: перезапускаем 
библиотека: библиотеку библиотеке библиотека 
вкладка: вкладку вкладка 
заняться: займемся 
показ: показа 
кликать: кликаем 
должный: должна должно 
пайтоня: пайтоне 
погуглить: погуглить 
поблагодарить: поблагодарить 
обработчик: обработчик обработчике обработчику 
добавить: добавить добавим 
сообщение: сообщение сообщением сообщения сообщению 
присоединить: присоединим 
аггга: аггга 
расказать: раскажу 
помощь: помощью помощь 
галочка: галочку 
нужно: нужно 
фото: фото 
песочница: песочницы 
кнопка: кнопка кнопок кнопки кнопку 
писать: пишем 
определённый: определенную определенной 
простой: проще 
язык: языка язык 
требоваться: требуется 
последок: последок 
бот: ботом боте бот бота боты 
дзен: дзен 
ыбирай: ыбираем 
дальнейший: дальнейшей 
мой: моем 
поиск: поиск 
использовать: использовать использую 
забывать: забываем 
второй: втором 
код: кодом код коде 
карма: карма 
вызывать: вызывает вызываем 
тип: типа тип 
компьютер: компьютере 
класс: класса 
работа: работы работа 
управление: управления 
далее: далее 
небольшой: небольшую 
настройка: настройка 
решение: решений решение 
подключиться: подключимся 
отвечать: отвечает отвечаем 
быть: суть будем 
профиль: профиль 
заполнять: заполняем 
выбирать: выбираете 
начало: начала 
около: ок 
изменить: изменим 
старый: старую 
этот: этому эта 
выключаться: выключался 
написание: написании 
экземпляр: экземпляр 
форматирование: форматирования 
готовый: готова 
содержимое: содержимым 
указать: указали 
говорить: говоря 
это: это 
чайник: чайников 
внизу: внизу 
похожий: похожее похожие 
команда: команды команду команде 
наш: нашу наш наши нашими 
поддержка: поддержка 
делать: делаем 
подстроиться: подстроится 
добавлять: добавляем 
телеграм: телеграм телеграме 
запуск: запуске запуска 
результат: результат 
скорее: скорее 
дать: данной данные 
составить: составим 
способ: способ 
хаба: хабы 
атрибут: атрибут 
количество: количеству количество 
отправить: отправим 
создать: создали создать создадим 
образ: образом 
выглядеть: выглядит 
целое: целое 
туториал: туториал 
пользователь: пользователь 
умолчание: умолчанию 
появиться: появится 
пустой: пустая 
который: которая которых которую которое 
пугаться: пугайтесь 
нужный: нужна нужными 
последний: последнюю последней 
колонка: колонки колонка колонку 
предидти: предидущее 
отлично: отлично 
такой: такое такая 
идти: идет 
следующий: следующим 
тег: теги 
сделать: сделаем 
ниже: ниже 
прочтение: прочтение 
просмотреть: просмотреть 
например: например 
заполнить: заполнена 
шаблон: шаблон 
тестировать: тестирую 
вопрос: вопросы 
возле: возле 
работета: работет 
таблица: таблица таблицы таблице 
проверка: проверки 
путь: путь 
товар: товар 
информация: информацией информацию информация 
итак: итак 
исправимый: исправим 
слева: слева 
доставать: доставать 
телеграмма: телеграмм 
колба: колб 
колбэк: колбэке колбэк колбэка 
просто: просто 
ами: ами 
нормально: нормально 
рабооотать: рабооотает 
тест: теста 
окно: окно окне 
фотография: фотографией фотография 
версия: версию 
сочетание: сочетание 
удалить: удалить 
сверху: сверху 
окей: окей 
проверить: проверим 
первый: первую первой 
отображаться: отображаться 
переходить: переходим 
наметить: наметим 
обратить: обратите 
история: истории 
программа: программе 
помнить: помним 
содержать: содержать 
хороший: лучшие 
пусть: пусть 
хотеться: хотелось 
вчера: вчера 
добро: добро 
импортировать: импортируем 
умолчаня: умолчаню 
приветствовать: приветствовал 
понимать: понимать 
создавать: создаем 
отлавливать: отлавливать 
задавать: задаём задаем 
метод: методом 
параметр: параметрами параметром параметра 
аргумент: аргументы аргумент 
мина: мин 
передаваться: передаваться 
статья: статьи 
забыть: забыл 
работать: работает 
сутки: сутки 
приходить: приходит 
перелистывать: перелистывает перелистывать 
разработчик: разработчик 
функция: функцию 
вакансия: вакансии вакансий 
пожаловать: пожаловать 
выше: выше 
получение: получение 
данные: данных 
засовывать: засовывать 
отследить: отследить 
наслать: нашли 
строчка: строчка 
прекрасно: прекрасно 
рейтинг: рейтинг 
перелистывание: перелистывания 
продолжать: продолжаем 
новый: новое 
технический: техническая 
немой: нем 
полный: полный 
пункт: пункт 
картинка: картинке 
жать: жмем жмете 
закладка: закладки 
цифра: цифры 
что: чём 
пропустить: пропустить 
проверять: проверяем 
открытие: открытии 
вернуться: вернуться 
показывать: показывает 
вспоминать: вспоминаем 
интернет: интернете 
смысл: смысл 
устанавливать: устанавливаем 
хабра: хабр 
юзер: юзеру 
вывести: выведем вывести 
имя: имя 
обновить: обновить 
название: название 
время: время 
значит: значит 
запись: записей 
просмотр: просмотров 
публикация: публикации 
файл: файл 
узнать: узнать узнаем 
данный: данный 
план: план 
нибуть: нибуть 
запускать: запускаем 
описание: описание описанием 
обращаться: обращаться 
старт: старт 
обязательно: обязательно 
клик: клик 
ссылка: ссылка 
присобачить: присобачим 
номер: номер 
магазин: магазин 
находить: находим 
число: число 
ячейка: ячейкам 
записывать: записываем 
папка: папке 
случай: случае 
каждый: каждая 
токен: токен 
создание: создания 
пример: пример 
купить: купить 
пара: пару 
видеть: видим 
открыться: открывшемся 
синий: синим 
удаление: удаление 
