весь: весь всем 
ваш: ваш 
различный: различных 
позволить: позволило 
ответ: ответ ответа 
готовый: готовых 
система: системой система системы 
любой: любого 
препарат: препаратов 
сборка: сборку 
конечный: конечных 
яндекс: яндекс 
особенность: особенность 
поскольку: поскольку 
нужный: нужны нужного нужные нужен нужный 
простой: простая 
наверняка: наверняка 
рассказать: рассказать 
смотреть: смотрим 
мдлп: мдлп 
сила: сил 
комментарий: комментарии комментариях 
голос: голосов 
перейти: перейти 
известный: известную известны 
серийный: серийный 
достойный: достойной 
написать: написал 
страница: страницу 
сертификат: сертификата сертификатом сертификатов сертификат 
меню: меню 
интересный: интересному 
актуально: актуально 
задача: задача задач 
конкретно: конкретно 
библиотека: библиотеку библиотеки 
единица: единиц 
поиск: поиске поиск 
наткнуться: наткнуться 
раздел: разделе раздел 
чудо: чудо 
добавить: добавить 
авторизационный: авторизационный 
статистический: статистические 
подпись: подписи подпись 
разом: разом 
кто: кого 
нужно: нужно 
юридический: юридическими 
ресурс: ресурсе 
песочница: песочницы 
контур: контур 
получать: получаем 
сделать: сделать сделали 
язык: языка язык 
чз: чз 
который: которые который которую 
шаг: шаг шаге 
подробность: подробностей 
подписывать: подписывать подписываем 
дзен: дзен 
реализация: реализация 
административный: административных 
статья: статью статье статьи 
отнять: отнял 
авторизация: авторизации авторизация 
найтись: нашлось 
первый: первые 
адрес: адресами 
собственно: собственно 
забрать: забрать 
использовать: использовать 
причина: причине 
сайт: сайте 
карма: карма 
заменить: заменить 
движение: движении 
работа: работы работа 
результат: результате 
поздравлять: поздравляю 
источник: источников 
интеграция: интеграцией 
далее: далее 
небольшой: небольшую 
импорт: импорте 
продукция: продукции 
камень: камни 
маркировка: маркировки маркировка 
процесс: процессе 
настройка: настройка настройки 
плагин: плагины плагин 
привет: привет 
опускаться: опускается 
необходимо: необходимо 
профиль: профиль 
быть: буду 
ошибка: ошибки ошибка 
тот: тех той 
мочь: можем 
подводный: подводные 
закодировать: закодируйте 
душа: душе 
основный: основное 
подписать: подпишете 
старый: старую 
ключ: ключ ключа 
сохранить: сохранённый 
её: её 
заключительный: заключительный 
лишний: лишним 
это: это 
электронный: электронная 
этап: этапе этапа 
поддержка: поддержка 
хранилище: хранилище 
держать: держите 
лекарственный: лекарственных 
проверять: проверял 
пример: примеры примере 
лёгкость: легкостью 
передать: передать передали 
особо: особо 
ссылка: ссылку ссылка 
рука: рукой 
текущий: текущий 
дать: данной данные 
хаба: хабы 
рамка: рамках 
атрибут: атрибут атрибутом атрибутов 
подписание: подписания 
следующий: следующие 
взять: взять 
свой: своем 
вопрос: вопросов вопросы вопрос 
продажа: продаж 
тп: тп 
время: времени время 
обратно: обратно 
помочь: помогли поможет 
повторить: повторили 
статистика: статистика 
объявлять: объявляем 
происходить: происходит 
проблема: проблем 
проект: проект 
личный: личный личное 
большинство: большинстве 
устанавливать: устанавливать 
такой: такое 
господь: господь 
переписать: переписать 
интерфейс: интерфейс 
сам: самому 
тег: теги 
браузер: браузера 
проверить: проверьте проверить 
скопировать: скопировать 
перечислить: перечислю 
уровень: уровень 
прочтение: прочтение 
востребовать: востребован 
оно: оно 
искать: ищем 
поэтому: поэтому 
дёргать: дергать 
расширение: расширение расширения 
предоставлять: предоставляет 
креда: креды 
пользователь: пользователей 
проверка: проверки 
достучаться: достучаться 
один: одна 
начать: начали 
рад: рад 
читать: читать 
морозов: морозов 
включать: включает 
итак: итак 
получить: получить получили полученного 
оттуда: оттуда 
передача: передачи 
широко: широко 
занять: заняли 
автоматизация: автоматизации 
просто: просто 
добавлять: добавляет 
каков: каковы 
знак: знак 
важно: важно 
вскоре: вскоре 
назад: назад 
версия: версию 
честный: честный 
товар: товаров 
хотя: хотя 
наш: наши нашем 
бизнес: бизнесе 
лицо: лицами 
установить: установили установить 
также: также 
элемент: элементы 
эцп: эцп 
администрирование: администрирование 
переходить: переходим 
рекомендация: рекомендация 
переменный: переменную 
этот: эта 
мы: нам 
история: истории 
сталкиваться: сталкивался 
предыдущий: предыдущем 
отправлять: отправляем 
вызывать: вызываем 
догадаться: догадались 
средний: средний 
некоторый: некоторые 
объект: объект объектам объекты 
сессия: сессии 
зарегистрировать: зарегистрирован 
установка: установка 
создание: создание 
документация: документацию документации 
ответить: ответить 
удаться: удалось 
кабинет: кабинет 
хороший: лучшие 
аутентификация: аутентификации аутентификация 
рекомендовать: рекомендую 
прийтись: пришлось 
ранее: ранее 
импортировать: импортируем 
мина: мин 
решение: решение решении 
работать: работает 
артём: артём 
сутки: сутки 
учётный: учетные 
добавляться: добавляются 
хранить: храни 
разработчик: разработчик 
сказать: сказано 
вакансия: вакансии вакансий 
получение: получение 
потерять: потеряли 
данные: данных 
остаться: остались 
усовершенствовать: усовершенствованной 
метод: методов 
кэп: кэп 
рейтинг: рейтинг 
отметить: отметим 
разработческий: разработческий 
технический: техническая 
обращаться: обращаемся 
отдельно: отдельно 
количество: количество 
пока: пока 
называться: называется 
пункт: пункт 
инструмент: инструмент 
довольно: довольно 
отчасти: отчасти 
закладка: закладки 
понадобиться: понадобится понадобиться 
опыт: опытом 
похожий: похожие 
вернуться: вернуться 
порядок: порядку 
страничка: страничку 
интернет: интернете 
верно: верно 
хабра: хабр 
таки: таки 
код: код 
сложность: сложности 
момент: момент 
гайдов: гайдов 
час: часа 
обновить: обновить 
комп: компе 
основа: основы 
немало: немало 
откреплять: открепляемая 
идти: идти 
цель: цель 
стоить: стоит 
просмотр: просмотров 
публикация: публикации 
лк: лк 
поделиться: поделиться 
данный: данный 
мало: мало 
информация: информация 
х: х 
часть: части 
константа: константы 
триальный: триальную 
обязательно: обязательно 
повезти: повезло 
номер: номер 
авторизоваться: авторизоваться 
показаться: показалась 
слово: слова 
хотеть: хочу 
случай: случае 
токен: токен 
аналитический: аналитические 
прилетать: прилетать 
криптопро: криптопро 
насобирать: насобирали 
криптографический: криптографическое 
сначала: сначала 
другой: других 
убедиться: убедитесь 
