мочь: могут 
ваш: ваш 
задача: задачи 
иностранный: иностранных 
совокупность: совокупность 
глобальный: глобальном глобального глобальный глобальными 
облачный: облачные облачной облачными облачную облачного 
разместить: размещенная размещенных разместить 
ценный: ценные 
база: базы базе базу база 
внимание: внимание 
пользователь: пользователи пользователя пользователей 
провайдер: провайдерами провайдера 
яндекс: яндекс 
отличаться: отличаются 
нужный: нужны нужна 
возможно: возможно 
зарегистрировать: зарегистрированные 
гбитый: гбит 
компания: компаниям компании 
содержание: содержание 
погружение: погружения 
участвовать: участвовать 
разобраться: разберемся 
полный: полной 
сервис: сервисам сервисов сервис сервисы 
один: одну одном одной 
комментарий: комментарии 
организовать: организовать организуем организована организовано 
регион: регионах регионами региона 
голос: голосов 
инфраструктура: инфраструктурой инфраструктуры инфраструктуру инфраструктура 
меню: меню 
различный: различные 
часть: часть 
сторонний: сторонние сторонним 
сервер: сервере сервер сервером сервера серверами серверы 
выбор: выбору выбор 
домен: домен 
материальный: материальные 
безопасность: безопасности 
высокий: высокая высоким высокий 
выделить: выделенным выделенное выделенного выделенные выделенный выделенными 
такой: такими такого такая 
хватить: хватить 
войти: войдите 
низкий: низкий 
неоптимальна: неоптимальна 
храниться: хранятся 
высокоскоростной: высокоскоростное 
добавить: добавить 
полезный: полезна 
зависеть: зависит 
помощь: помощью 
нужно: нужно 
винтажный: винтажная 
пожалуйста: пожалуйста 
требование: требованию 
язык: языка язык 
который: которые которым которая которых которую которое которого 
пароль: паролей 
требовать: требует 
бесплатный: бесплатен 
находиться: находится 
учесть: учесть 
дзен: дзен 
сегмент: сегменты 
какой: какую какие 
ефименко: ефименко 
резервировать: резервируем 
приходить: приходят 
издержка: издержек издержки 
физически: физически 
аудиотехника: аудиотехника 
поиск: поиск 
зрение: зрения 
пул: пулах 
использовать: использовать использует используете 
существовать: существует 
второй: втором 
реализовывать: реализовывать 
карма: карма 
дата: дата 
клиент: клиент клиентов клиенты 
хостит: хостит 
мера: мере меры 
работа: работы 
архитектура: архитектуры архитектура 
данные: данным данных 
распределение: распределение 
построить: построить 
вычисление: вычислений 
генерация: генерации 
несколько: несколько нескольких 
место: месте 
проголосовать: проголосовали 
нагрузка: нагрузки нагрузок 
трафик: трафик трафиком 
заключение: заключение 
проблема: проблема 
настройка: настройка 
гибкость: гибкость гибкости 
избежать: избежать 
связь: связи 
профиль: профиль 
потреблять: потреблять 
кабель: кабели 
объединять: объединяемые объединять 
разнести: разнесенные 
начало: начала 
подключать: подключать 
старый: старую 
сеть: сети сеть 
недостаток: недостатки 
распределённый: распределенную распределённые 
территориально: территориально 
услуга: услуга услуг услугу услуги 
технология: технология технологию технологии 
проект: проектами проектов проекты 
хоститься: хостятся хостится 
это: это 
упасть: упадет 
квалификация: квалификации 
кой: кое 
машина: машине машинах 
маршрутизатор: маршрутизаторов 
высокопроизводительный: высокопроизводительных 
покупка: покупки 
любой: любую 
поддержка: поддержка 
обзор: обзор 
хранилище: хранилище 
дополнительный: дополнительной дополнительные 
сетевой: сетевую сетевой сетевые сетевая 
разница: разница 
потерять: потеряете 
хранить: хранить 
платформа: платформой платформами платформу 
приватный: приватной приватное 
позволять: позволяет 
хаба: хабы 
рамка: рамках 
виртуальный: виртуальной виртуальных 
получиться: получилось 
повлечь: повлечь 
центр: центрами центра центре центрах центры 
внутри: внутри 
воскресный: воскресной 
основной: основной 
кат: катом 
бизнес: бизнеса 
роутер: роутер роутере роутера 
администратор: администраторов 
квалифицировать: квалифицированные 
среди: среди 
провайдерский: провайдерским 
перенести: перенести 
отдельный: отдельной отдельных 
тег: теги 
текст: тексты 
средство: средства 
ресурс: ресурсы ресурсов 
уровень: уровень уровнем 
подключение: подключение 
прочтение: прочтение 
например: например 
вычислительный: вычислительных 
поэтому: поэтому 
разный: разные разных 
особенно: особенно 
интернет: интернет 
соединение: соединение соединений 
вопрос: вопросами 
отказоустойчивость: отказоустойчивости 
система: системы 
построение: построения 
способ: способы способов 
важный: важен 
кроме: кроме 
оператор: оператором 
минус: минус 
однозначный: однозначен 
облако: облаком облако 
барахолка: барахолке 
объединить: объединить объединенных 
железо: железо 
рациональный: рациональное 
выгодный: выгодна 
описать: описанной 
выход: выхода 
магистральный: магистральным 
валенсия: валенсией 
подход: подхода 
полоса: полосы 
сам: само 
порт: порты 
подробный: подробнее 
использование: использовании 
версия: версию 
зарезервированный: зарезервированных 
стабильный: стабильное 
балансировщик: балансировщик 
зарубежный: зарубежными зарубежного зарубежным 
связность: связности связность 
протягивать: протягиваем 
мы: нам 
обратить: обратите 
связать: связать 
пиковый: пиковых 
первый: первом 
комбинировать: комбинировать 
агрегатор: агрегатора 
комментировать: комментировать 
встроить: встроен 
точка: точки 
достаточно: достаточно 
регулятор: регуляторов 
содержать: содержать 
хороший: лучшие 
следовать: следует 
настроить: настроить 
бот: бота 
старт: старта 
сценарий: сценарий 
мина: мин 
веб: веб 
внешний: внешнюю 
воздержаться: воздержались 
устанавливаться: устанавливается 
штатный: штатных 
сутки: сутки 
давать: дает 
сложный: сложных 
располагаться: располагаться 
географически: географически 
влад: влад 
критично: критично 
разработать: разработать 
преимущество: преимущества 
физический: физическом 
неограниченный: неограниченным 
временной: временные 
маршрутизация: маршрутизации 
последний: последний 
хотеть: хотите 
рейтинг: рейтинг 
возможный: возможный 
писатель: писатель 
неоптимальный: неоптимального 
другой: другие 
вконтакте: вконтакте 
доступ: доступ 
логический: логические 
технический: техническая технический 
немой: нем 
отсутствие: отсутствие 
актуальный: актуальна 
самостоятельно: самостоятельно 
количество: количество 
гайда: гайд 
список: списке 
опрос: опросе 
вариант: вариантов 
заинтересовать: заинтересуют 
закладка: закладки 
простой: простой 
расположить: расположить 
похожий: похожие 
площадка: площадке 
вернуться: вернуться 
представить: представьте 
себя: собой 
хабра: хабр 
производительность: производительность 
сложность: сложности 
момент: момент 
хватать: хватает 
гипероблако: гипероблаком 
файловый: файловое 
специалист: специалисты 
оборудование: оборудования 
обновить: обновить 
файл: файлы 
время: время 
дать: данные дать 
гибридный: гибридную 
основа: основе 
просмотр: просмотров 
необходимость: необходимости 
публикация: публикации 
решение: решения 
оплата: оплаты 
понадобиться: понадобиться 
постараться: постарались 
они: ними 
единый: единую 
потребление: потребления 
локальный: локальную 
быть: будут 
книга: книг 
вынести: вынести 
масштабирование: масштабировании 
рассказывать: рассказываем 
собрать: собрать 
случай: случае 
блог: блог 
расход: расходы 
новый: новый 
разобрать: разберем 
мара: мар 
картина: картина 
арендовать: арендовать 
