оказаться: оказаться 
молчать: молчать 
планировать: планировать 
свой: своего 
пентестер: пентестеров пентестером пентестера 
вывод: вывод вывода 
большой: большой 
спасибо: спасибо 
гик: гику гикам гика гиков 
день: дне 
некоторый: некоторым некоторые 
длинный: длинную 
вызываться: вызывалась вызываются 
давно: давно 
знать: знают 
выбор: выбора 
яндекс: яндекс 
доработать: доработать 
сей: сей 
консоль: консоли 
удивительный: удивительным 
комментарий: комментарии 
удерживание: удерживанием 
голос: голосов 
разработчик: разработчики разработчикам 
выложить: выложил 
романтизировать: романтизировать 
дружелюбный: дружелюбный 
прошлое: прошлого 
меню: меню 
флиппер: флиппере флиппер 
замечательный: замечательный замечательная 
судить: судя судить 
конкретно: конкретно 
выпилить: выпилить 
глаз: глаз 
выражать: выражаю 
выводить: выводит 
устройство: устройстве устройствами 
игрушка: игрушкой 
порядок: порядка 
добавить: добавить 
сообщение: сообщение 
завертеться: завертелось 
нужно: нужно 
интересно: интересно 
пользователь: пользователя пользователь 
писать: пишем писал писать 
сделать: сделать 
язык: языка язык 
идея: идея 
дзен: дзен 
возможность: возможность возможности 
поправить: поправили 
реализация: реализация 
электроника: электроники 
прямо: прямо 
резюмировать: резюмируя 
определение: определение 
набирать: набирать 
буква: буквы буква 
поиск: поиск 
привычка: привычки 
существовать: существует 
прочитать: прочитав 
читать: читает 
код: кодом кода код коде 
карма: карма 
приложение: приложение 
работа: работы работу работа 
управление: управления 
содержать: содержит 
клавиатура: клавиатуру клавиатура 
эникейщик: эникейщика 
написать: написать 
девайс: девайс девайса 
участник: участникам 
зачесаться: зачесались 
понимать: понимаю 
настройка: настройка 
боль: боли боль 
прошивка: прошивку прошивки прошивке 
простыня: простыню 
вполне: вполне 
профиль: профиль 
безопасность: безопасность 
знакомый: знакомые знакомы 
тот: тех та 
лог: лога 
новогодний: новогодние 
преследовать: преследуют 
инициализироваться: инициализируется 
тамагоча: тамагочи 
б: б 
стать: стал 
старый: старую старые 
маленький: маленьком маленькой 
рабочий: рабочая 
скроллить: скроллить 
написание: написании 
опыт: опыта 
фантомный: фантомные 
групповой: групповой 
пролистывать: пролистывал 
быстрый: быстрых быстрого быстрые 
россия: россии 
ковырять: ковырял 
это: это 
плагин: плагинов 
принять: принято 
самый: самых 
обязательный: обязательной 
команда: команды команд 
взять: взят взял 
поддержка: поддержка 
лишний: лишнее 
делать: делаем делал 
быть: е 
функционал: функционал 
какой: какое 
черпать: черпать 
человек: людей 
первый: первая 
хаба: хабы 
различный: различными 
мочь: могу 
мудрость: мудрость 
интересный: интересными 
думать: думать 
туториал: туториал 
год: года 
сисадмин: сисадмина 
я: мною 
сообщать: сообщают 
умолчание: умолчанию 
ещё: ещё 
приходиться: приходится 
дельфин: дельфином дельфин 
проект: проект проекта проекте 
иметь: имея 
печаль: печаль 
роутер: роутер 
нуль: нуля 
сообщество: сообщества 
такой: такое такого таком 
интерфейс: интерфейс 
чат: чат 
извращение: извращение 
обычно: обычно 
тег: теги 
грандиозный: грандиозные 
каникулы: каникулы 
скопировать: скопировать 
терминал: терминалу терминала терминале терминал 
подключение: подключение 
пользовательский: пользовательские 
прочтение: прочтение 
благодарность: благодарность 
огромный: огромное огромную 
павел: павла 
информационный: информационная 
поэтому: поэтому 
кибер: кибер 
инициализация: инициализацию 
компания: компании 
зубайраев: зубайраев 
публикация: публикация публикации 
серьёзно: серьезно 
рассчитать: рассчитана 
статья: статья 
путь: путь 
сборка: сборка 
очень: очень 
запуск: запуска 
полезный: полезного 
август: августе 
разный: разных 
гаджет: гаджеты 
основа: основу основе 
вызывать: вызывать 
минус: минус 
чтение: чтение 
итак: итак 
жить: живет 
показаться: показались 
дисплей: дисплее 
отсутствовать: отсутствовала 
просто: просто 
телефон: телефона 
канал: канал 
производство: производство 
постичь: постигла 
всё: всё 
стоковый: стоковой 
версия: версию версии версия 
кто: кому 
хотя: хотя 
фича: фичу 
занятие: занятие 
общий: общем 
мультитул: мультитул 
также: также 
заслуженно: заслуженно 
реализовать: реализовано 
который: который которое котором 
получиться: получилась 
плюс: плюс плюсов 
попросить: попросили 
экран: экран 
нормальный: нормальных 
добрый: добрых 
яковлев: яковлева 
относить: отношу 
установка: установка 
кратер: кратера 
процесс: процесс 
дело: дела 
практически: практически 
текст: текста текст 
ввод: ввода 
хороший: лучшие 
прийтись: пришлось 
вчера: вчера 
родный: родная 
ранее: ранее 
крохотный: крохотного 
разработка: разработке разработка 
оставаться: оставалось 
сайт: сайт 
подобный: подобный 
документация: документации 
старт: старта 
строго: строго 
мина: мин 
зваться: зовется зваться 
ноутбук: ноутбука 
исходный: исходным 
сутки: сутки 
компактный: компактный 
провести: провел 
хватать: хватало 
цифровой: цифровой 
мир: мир 
выше: выше 
просить: прошу 
разместить: разместить 
набор: набора наборе набор 
рука: руки 
последний: последней 
нелишний: нелишним 
немного: немного 
хотеть: хотите 
рейтинг: рейтинг 
предусмотреть: предусмотрен 
вконтакте: вконтакте 
слать: слать 
образ: образов 
один: одной 
сказать: скажу 
технический: техническая 
участь: участь 
отправка: отправка 
символ: символы символов 
условие: условиях 
количество: количество 
пока: пока 
гусар: гусары 
считать: считаю 
мультитулом: мультитулом 
уметь: умеет 
изучать: изучая 
принимать: принимает 
закладка: закладки 
изначально: изначально 
цифра: цифры 
снять: снял 
заметить: заметил 
гордо: гордо 
видео: видео 
похожий: похожие 
вернуться: вернуться 
небольшой: небольшое 
пробел: пробел 
хабра: хабр 
курс: курсе 
знакомство: знакомство 
сразу: сразу 
интернет: интернетах 
обновить: обновить 
привести: приведу 
встроить: встроенная 
минимум: минимум 
время: время 
подчёркивание: подчеркивание 
просмотр: просмотров 
прошлый: прошлом 
решение: решения 
поделиться: поделиться 
голый: голом 
исходник: исходникам исходников 
малиновый: малиновых 
ссылка: ссылка 
обсуждение: обсуждений 
слово: слова 
заглавный: заглавной 
рассказывать: рассказываем 
блог: блог 
приятный: приятных 
купить: купить 
решить: решил 
новый: новой 
спортмастер: спортмастер 
вообще: вообще 
скорость: скорости 
тусовка: тусовок 
узнать: узнал 
