мягкий: мягкий мягкое мягкого мягкой мягких мягкими 
существо: существ существа 
лишить: лишены 
материал: материалов материалами материалы 
мочь: могут могли 
учёный: ученых ученые 
определяться: определяется определялся 
спереди: спереди 
структура: структура структуры структурой 
степень: степени 
робот: робот робота роботов роботы роботам 
чувствительность: чувствительности 
модуль: модуль модуля 
угол: углу угол углом углами 
прежний: прежнему 
приложение: приложения приложений 
фолликулярный: фолликулярные 
конечный: конечном конечную 
электрический: электрическому электрическое 
иметься: имеются 
различный: различных различные различной различными различным различную 
повторять: повторяя 
свой: своего своем своим 
отделение: отделения 
вероятно: вероятно 
звено: звенья 
спасибо: спасибо 
мышечный: мышечными 
заблокировать: заблокированный 
гусеница: гусеницы гусениц гусеница 
создавать: создаваемого создает 
система: системой системы систему 
релаксация: релаксации релаксация 
адгезионный: адгезионный адгезионной адгезионное адгезионные адгезионных адгезионную 
являться: является являются 
клетка: клетки 
поверхность: поверхностями поверхностям поверхностей поверхностях поверхности поверхностью поверхность 
область: области область 
путём: путем 
изображение: изображение 
учитывать: учитывая 
частность: частности 
придумать: придуман 
имитировать: имитировать имитирует имитировала 
поле: поле полем поля полю 
обеспечивать: обеспечивали обеспечивающий обеспечивающей обеспечивает обеспечивало 
изгибать: изгибающий изгибаемого 
добраться: добраться 
разработка: разработки разработка 
интенсивность: интенсивности интенсивностью 
фотостационарный: фотостационарное 
правый: правого правый правой 
асимметричный: асимметричное асимметричного 
поскольку: поскольку 
детальный: детального 
нужный: нужны 
яндекс: яндекс 
динамический: динамического динамическим 
исходный: исходные исходного 
нога: ноги ног нога 
напряжение: напряжением напряжения 
будущее: будущем 
медленно: медленно 
гбитый: гбит 
соответственно: соответственно 
индуцировать: индуцированной 
деформация: деформации деформация деформацией деформацию 
гибридный: гибридной гибридных 
знакомый: знакомым 
основываться: основываясь 
кривизна: кривизна кривизны 
контакт: контакту контакта 
вызвать: вызванной вызванные 
повышение: повышения повышение 
стоимость: стоимостью 
представить: представлен 
позволять: позволяющие позволяет позволяют позволяющее позволяя 
ключевой: ключевым 
вертикальный: вертикальным 
плоскость: плоскости 
способность: способность способности способностями способностью 
облучение: облучения облучение облучении 
источник: источнику 
представлять: представляет 
один: одну одним 
комментарий: комментарии 
больший: большему больший большую большим 
голос: голосов 
разработчик: разработчики разработчиков 
состояние: состояния состояние состоянии 
внешний: внешнему 
показать: показано показанной показал 
вдоль: вдоль 
перемещаться: перемещался перемещалось перемещаться 
стимул: стимулы 
каков: какова 
меню: меню 
отвесный: отвесным 
обратимый: обратимое обратимому обратимая 
разработать: разработали разработанного разработать разработан 
тот: тому те той 
связать: связан связано 
амстердам: амстердаме 
землемерка: землемерки землемерка землемерками землемерку 
функция: функции 
туловище: туловище туловища туловищу 
интересный: интересных 
объединить: объединили объединив 
далее: д далее 
обусловить: обусловлено 
восходящий: восходящую 
несоответствие: несоответствия 
часть: часть части 
какой: какому 
устойчивый: устойчивую 
сила: силу сила силой силы силами 
механизм: механизмы механизм механизмов 
волосок: волоски 
другой: другим другими другому других 
чувствительный: чувствительной чувствительное 
левый: левый левую левого левой 
увеличить: увеличить 
правда: правда 
именно: именно 
поведение: поведение поведения поведением 
возникать: возникать возникающая 
производственный: производственного 
зазор: зазора 
весь: вся всем 
размер: размером 
ван: ван 
живой: живых живой 
полимерный: полимерной полимерная 
грибообразный: грибообразная 
контактный: контактной 
физика: физика 
лазать: лазать лазающих 
творение: творения 
площадь: площади площадь 
ближний: ближнее 
смещение: смещении смещение смещения 
нюанс: нюансами 
начинать: начинает 
добавить: добавить добавлен 
измерение: измерений 
межфазный: межфазных межфазного 
уф: уф 
однако: однако 
обеспечить: обеспечило обеспечить 
концепция: концепцию 
липкий: липких липкие 
ответ: ответы 
прилипание: прилипание прилипания 
прекращение: прекращения 
синергия: синергию 
помощь: помощью 
сбалансировать: сбалансировать 
геккон: геккона гекконами гекконы гекконам геккон гекконов 
такой: такие такое таким такая таких 
видно: видно 
нужно: нужно 
подключение: подключения 
высота: высотой 
миниатюризация: миниатюризации 
собака: собак 
находиться: находятся 
столбик: столбики столбика 
липкость: липкость 
пример: примеру примере 
ядро: ядер 
усиленный: усиленного 
обладать: обладающая обладают обладает 
подъёмный: подъемную 
отсоединение: отсоединение отсоединением отсоединения 
что: чему 
биологический: биологические биологической 
расстояние: расстояние 
справа: справа 
обеспечение: обеспечения 
вид: виде 
давать: давать 
возможность: возможностью возможность 
пара: пары 
плотность: плотность 
порекомендовать: порекомендовав 
требоваться: требуется 
язык: языка язык 
который: которые которой которая которых который которого 
безграничный: безгранична 
шаг: шаг 
метод: метод методом 
требовать: требует 
сделать: сделав 
интеллектуальный: интеллектуальных 
внутренний: внутренние 
прокручиваться: прокручивающееся 
ткань: тканей ткани 
дзен: дзен 
конвенциональный: конвенциональные 
продемонстрировать: продемонстрировали 
итог: итоге 
дер: дер 
бесконтактный: бесконтактного бесконтактные 
спроектировать: спроектированы 
разный: разной разными 
значительный: значительные 
реализоваться: реализуются 
толщина: толщина 
шероховатость: шероховатостью 
сервер: сервер серверы серверов 
подтвердить: подтвердить подтверждена 
несовершенный: несовершенному 
определённый: определенные определенной 
передача: передачу 
уникальный: уникальной уникальный 
поиск: поиск 
сцепление: сцепления 
микроскоп: микроскопа 
смотреть: см 
мышца: мышцы 
доклад: доклад докладе 
провайдер: провайдер 
существовать: существует 
использоваться: использовались использовался использовалось 
подложка: подложкам подложке подложки подложек 
дорога: дороги 
нестационарный: нестационарное нестационарным 
исключительный: исключительными 
адгезия: адгезии адгезию адгезия 
локальный: локальная локальной локального 
реализация: реализации 
карма: карма 
вызывать: вызывает 
ускорить: ускорить 
заменить: заменить 
дата: дата 
найти: найдем 
результат: результате результатах 
работа: работы работу 
движение: движении движению движением движение движения 
класс: класса 
управление: управления 
цель: целью 
демонстрировать: демонстрировал 
кончик: кончика кончик 
излучение: излучения излучение 
данные: данным данными 
уменьшаться: уменьшается 
принцип: принцип принципы 
построить: построить 
последовательность: последовательности 
беспроводный: беспроводная 
длина: длину длина длины 
нагрузка: нагрузки 
покрыть: покрыты 
шаблон: шаблона 
процесс: процессе процесс процесса 
популярный: популярное 
полезный: полезным 
сегодня: сегодня 
заглянуть: заглянуть 
оставаться: остаётесь остается оставаться 
настройка: настройка 
научно: научно 
производить: производил 
два: двумя двух две 
необходимо: необходимо 
открепляться: открепляется 
анизотропный: анизотропной 
инфракрасный: инфракрасное 
эффективный: эффективная эффективное эффективного 
отрыв: отрыва 
биология: биология 
клейкий: клейкие клейкая 
вполне: вполне 
мономер: мономеры 
захват: захвата 
профиль: профиль 
прочность: прочности прочность 
работоспособный: работоспособных 
перемещение: перемещении 
иерархический: иерархической иерархическая 
правильно: правильно 
робототехника: робототехнику робототехники робототехника 
механический: механическую механической механические 
блок: блоку 
цепляться: цепляться 
алюминий: алюминий 
положительный: положительную 
постепенно: постепенно 
начальный: начальные начального 
отклоняться: отклонялся 
применять: применяя 
висеть: висела 
синтетический: синтетические 
термический: термической 
конструкция: конструкции конструкция 
уровень: уровне 
фантазия: фантазия 
иной: иные 
начало: начала 
сходство: сходством 
основный: основными основного 
смочь: смогли 
достигнуть: достигнув достичь 
акрилата: акрилат 
стеклянный: стеклянной 
университет: университета 
влажность: влажность 
утрировать: утрировано 
тело: тело телом тела 
лёгкий: легкой 
задний: задняя 
лента: ленты 
создать: созданы создали создать 
сеть: сети 
фоточувствительный: фоточувствительным фоточувствительных фоточувствительное 
населять: населяющие 
сбоку: сбоку 
стабилизировать: стабилизировать 
касаться: касается 
прозвать: прозвали 
исключительно: исключительно 
раз: раза 
диаметр: диаметр диаметром 
успешный: успешны 
состоять: состоящего 
прикрепить: прикрепленной прикрепленного 
воздействие: воздействии воздействия 
скорость: скоростью 
называть: называемый 
упругость: упругости 
решить: решили 
он: нему 
расщепление: расщепления 
жёсткий: жестким жестких 
грибовидный: грибовидных грибовидные 
сторона: стороны 
фототермический: фототермического 
род: рода роде 
походка: походка 
ас: ас 
свет: света свет светом 
мгновенный: мгновенной 
крепление: креплением крепления 
трещина: трещин 
отрицательный: отрицательную 
прикрепление: прикрепления 
соответствовать: соответствующий соответствующую 
исследовать: исследовали исследованы 
говорить: говоря говорит говорить 
это: это 
приложить: приложить 
локомотивный: локомотивный 
подниматься: подниматься 
провести: провели 
вышеупомянутый: вышеупомянутый 
корп: корп 
непрерывный: непрерывной 
иметь: имеет иметь 
стабильный: стабильный стабильной 
знакомиться: знакомились 
электростатически: электростатически 
визуальный: визуальным 
ваальс: ваальса 
провод: провода 
получение: получения 
манипулировать: манипулировать 
предварительный: предварительной 
деталь: детали 
положение: положения 
удержаться: удержаться 
гибкий: гибкого 
заканчиваться: заканчиваются заканчивается 
быть: е 
композитный: композитной композитная 
гибкость: гибкости 
визуально: визуально 
диапазон: диапазон 
эквивалент: эквивалентами 
особо: особо 
копейка: копейки 
перемещать: перемещает 
деформировать: деформируемое 
время: временем времени время 
способ: способ 
должный: должен 
хаба: хабы 
ультрафиолет: ультрафиолет 
несмотря: несмотря 
описание: описания 
достигать: достигает 
шагать: шагает 
голова: головой 
труд: труде трудов 
исследование: исследованиями исследования 
операция: операциях 
центр: центрами центре 
образ: образом 
отметить: отмечены отметить 
организм: организма организм 
воздействовать: воздействовали 
рассматривать: рассматриваемом 
столб: столбов 
градиент: градиенту 
понимание: понимание 
быстрый: быстрое 
поднятие: поднятия 
пользователь: пользователь 
азобензол: азобензола 
сборка: сборки 
одинаковый: одинаковой одинаковом 
аналог: аналог 
магнит: магнит магнита 
привод: приводами привода приводов 
остаточный: остаточные 
практика: практике 
соединенный: соединенны 
трансформироваться: трансформируется 
передний: передняя 
инфраструктура: инфраструктуру 
наклон: наклона наклону 
липидный: липидный 
основа: основа основе 
усилие: усилием усилие 
взаимосвязь: взаимосвязи 
качество: качестве 
альпинист: альпинист 
переход: переход 
переходный: переходного переходном переходное 
прикрепляться: прикрепляться прикреплялся 
воссоздать: воссоздать 
дать: дало 
магнитный: магнитная магнитном магнитного магнитным магнитное 
превышать: превышает 
точность: точности 
мм: мм 
перенести: перенести 
течение: течение 
вышеописанный: вышеописанный 
снова: снова 
применить: применена 
приведение: приведения 
тег: теги 
плёнка: пленке пленка пленкой 
цикл: цикла циклов 
земля: землю 
преодолеть: преодолеть 
вниз: вниз 
азобензольный: азобензольные 
дешёвый: дешевле 
прочтение: прочтение 
конструкционный: конструкционные 
читать: читайте 
потолок: потолку потолке потолкам 
благодаря: благодаря 
применение: применения применением 
компания: компании 
мощность: мощность 
изгиб: изгиба изгибе изгибу 
мвт: мвт 
статья: статье статьи 
сильно: сильно 
дополнительный: дополнительные 
направление: направлении направления 
первый: первый 
состав: составом 
двигаться: двигаться 
поддержка: поддержка 
вопрос: вопросы 
компонент: компонентом 
форма: форму 
слово: словами 
нисходящий: нисходящий 
обратный: обратном 
микростолбик: микростолбиков 
стратегия: стратегии 
обыденность: обыденностью 
выровнять: выровненных выровненные 
использование: использованием 
вырезать: вырезаны 
приклеиваться: приклеивалась приклеивается 
получить: полученный 
управляемый: управляемой управляемого управляема управляемым 
канада: канада 
светочувствительный: светочувствительный светочувствительная 
кроме: кроме 
свойство: свойств 
помочь: помочь 
пунктирный: пунктирным 
ускоряться: ускорялось 
фотоуправляемый: фотоуправляемая фотоуправляемому 
единица: единицу 
напоминать: напоминает напоминающую 
планарный: планарной 
приводить: приводит приводя 
подготовить: подготовленного 
насколько: насколько 
отлипание: отлипания 
высокий: высокой 
стена: стенам 
ограничивать: ограничивает 
усовершенствовать: усовершенствовать 
сзади: сзади 
слегка: слегка 
выбрать: выбран 
оснастить: оснащены 
потенциальный: потенциальных потенциального 
глубина: глубины 
изгибаться: изгибающихся 
жидкокристаллический: жидкокристаллические 
регулировать: регулируемого 
радиус: радиус 
взаимодействие: взаимодействий 
касательно: касательно 
питание: питания 
стоящий: стоящий 
проиллюстрировать: проиллюстрировать 
лазание: лазания лазанья лазанию 
простой: простого 
способный: способного способных 
брюшной: брюшные 
поддержание: поддержания 
электронный: электронного 
затем: затем 
версия: версию 
растягивать: растягивающим 
отрываться: отрывается 
наш: наши нашей 
конфигурация: конфигураций конфигурации 
ознакомление: ознакомления 
средний: средней средним 
сверху: сверху 
биомиметический: биомиметических биомиметического биомиметической 
передвижной: передвижное 
эластичность: эластичности 
предшественник: предшественники 
подвижность: подвижность 
хотеть: хотели хотите 
характеристика: характеристик характеристики 
стимулировать: стимулирует 
срываться: срывался 
указывать: указывает 
постоянный: постоянного 
грудной: грудные 
рукотворный: рукотворные 
точнее: точнее 
также: также 
предел: пределах 
локомоция: локомоция 
революционный: революционным 
менее: менее 
вправо: вправо 
инженер: инженерам инженеров 
выходной: выходной выходная 
доступный: доступны 
стекло: стекло 
краситель: красителя 
мы: нам нами 
соединить: соединить 
поисковый: поисковых 
секунда: секунд 
вдохновиться: вдохновившись 
неоднократно: неоднократно 
первоначально: первоначально 
опыт: опыты 
некоторый: некоторые 
удерживаться: удерживается 
достаточно: достаточно 
матрица: матрицы 
преимущество: преимуществам 
слой: слой 
практически: практически 
вариант: варианты 
помогать: помогая 
удаться: удалось 
хороший: лучшие хорошей 
рекомендовать: рекомендую 
самый: самым 
ширина: ширины ширина ширине 
вчера: вчера 
палец: пальца пальцев 
дополнение: дополнение 
стать: стали 
гладкий: гладкая 
спасательный: спасательных 
прилипать: прилипать 
сайт: сайт 
сильный: сильных 
уотерл: уотерлу 
одновременно: одновременно 
подобный: подобный подобная 
кругом: кругом 
привязка: привязки 
реализовать: реализует 
действие: действием действие 
дело: дело 
горизонтальный: горизонтальной 
крепиться: крепится 
подножка: подножка 
мина: мин 
сложный: сложной 
увеличение: увеличением увеличении 
притяжение: притяжения 
удалённый: удаленную 
делить: делить 
фиксировать: фиксируя 
достижение: достижения 
составить: составило 
связанный: связанных связанными 
нестабильность: нестабильности 
природа: природы 
присущий: присуща 
жизнь: жизни 
происходить: происходила 
сутки: сутки 
влево: влево 
исключить: исключив 
крайне: крайне 
умение: умение 
трехслойный: трехслойная 
евро: евро 
обычный: обычным 
соответствие: соответствии 
большой: большое 
природный: природными 
ускорение: ускорении 
реклама: рекламы 
технология: технологии 
старый: старую 
тепловой: тепловая 
эпилог: эпилог 
работать: работать работая 
функциональный: функциональному 
выше: выше 
литература: литературы 
имитация: имитация имитации 
постоянно: постоянно 
правило: правило 
лапка: лапки лапок 
воздух: воздухе 
повышенный: повышенную 
туда: туда 
стабильно: стабильно 
собственный: собственными 
примерно: примерно 
стимулирование: стимулирования 
благо: благо 
геометрия: геометрии 
немного: немного 
использовать: использована использованы используя 
рейтинг: рейтинг 
корреляция: корреляцию 
изготовить: изготовили изготовлен 
роботизированный: роботизированном 
каждый: каждый 
фотохромный: фотохромным 
необычный: необычного 
технический: техническая 
эффект: эффекта 
подтверждение: подтверждением 
увеличиваться: увеличивалась 
полностью: полностью 
достаточный: достаточную достаточной 
микроструктура: микроструктурой 
отдельно: отдельно 
количество: количество 
пневматически: пневматически 
конец: концах концами 
пока: пока 
хостинг: хостинг 
переноситься: переносится 
давление: давлению 
мкм: мкм 
превосходный: превосходную 
плечо: плечо 
рыба: рыб 
универсальность: универсальность 
либо: либо 
оформить: оформив 
равнобедренный: равнобедренного 
закладка: закладки 
передвижение: передвижения 
нидерланды: нидерландах 
видео: видео 
нравиться: нравятся 
раздражитель: раздражителям 
похожий: похожие 
программировать: программируемой 
вернуться: вернуться 
многие: многие 
подробно: подробно 
себя: собой 
передвигаться: передвигаться 
поучиться: поучиться 
хабра: хабр 
намерить: намерены 
любой: любой 
момент: момент 
облачный: облачные 
белый: белым 
видеть: видеть видим 
содержать: содержащий 
край: края 
дистанционно: дистанционно 
отделиться: отделиться 
вязкоупругий: вязкоупругой 
обновить: обновить 
сконструировать: сконструирован 
восстанавливаться: восстанавливалась 
тепло: тепло 
необходимость: необходимость необходимости 
геометрический: геометрические геометрической 
ультрафиолетовый: ультрафиолетовое 
биомиметик: биомиметика 
субстрат: субстрату 
подаваться: подается 
полоска: полоска 
присоединение: присоединением присоединение 
однородный: однородный 
массив: массив 
ось: оси 
эластомер: эластомеры 
стоить: стоит 
просмотр: просмотров 
повторяться: повторяться 
осуществляться: осуществляется 
публикация: публикации 
сканировать: сканирующего 
так: т 
рассмотреть: рассмотренном 
расширить: расширить 
энергия: энергии 
сохраняться: сохраняются 
попытка: попытки 
уменьшить: уменьшенный 
заказ: заказ 
мн: мн 
критический: критический 
выполнять: выполняют 
привести: приведенных 
х: х 
фотон: фотонов 
объём: объема 
плоскостной: плоскостного 
отличие: отличие 
поддержать: поддержите 
тесно: тесно 
перпендикулярный: перпендикулярным 
верхний: верхней 
равный: равны 
оба: обоих 
колебание: колебания 
подушечка: подушечки подушечке 
счёт: счет 
полиимид: полиимид 
основное: основном 
интеграция: интеграции 
отклик: отклика 
тв: тв 
периодический: периодическую 
настраивать: настраиваемой 
случай: случае 
блог: блог 
подвижный: подвижного 
птица: птиц 
треугольник: треугольника 
дабы: дабы 
описать: описать описана 
ослабление: ослаблению 
отмечать: отмечают 
новый: новый 
тонкий: тонкой 
вместе: вместе 
особенность: особенности 
клейка: клейкой 
сначала: сначала 
магнитная: магнитной 
податливость: податливость 
фотомеханический: фотомеханическую 
назвать: назвать 
к: ко 
