ожидать: ожидать 
материал: материалов 
способность: способности способность 
система: системы система систем 
центр: центрах центров 
протокол: протокола протоколы 
заголовок: заголовка заголовках заголовок 
смешение: смешение 
профиль: профиль 
оператор: операторы 
данные: данных 
релиз: релиз 
конец: конец 
включать: включает 
пакет: пакеты пакета пакетов пакет 
контекст: контексте 
устанавливать: устанавливает 
специальный: специальный 
оперировать: оперирующих оперируют 
служить: служит 
встретить: встретили 
добавить: добавят добавить добавили 
начинать: начинают 
оптоволоконный: оптоволоконные 
облачный: облачные 
единый: единый 
второй: вторую 
означать: означает 
платформа: платформы 
поле: поле 
рейтинг: рейтинг 
увеличить: увеличила увеличить увеличенного 
кадр: кадры кадров 
передача: передачи 
уровень: уровне 
другой: другие других 
секунда: секунду 
реализовать: реализовал реализовали 
длина: длины длиной 
яндекс: яндекс 
задача: задач 
поскольку: поскольку 
пропускной: пропускной пропускную 
блог: блоге блог 
технический: техническая 
метод: методы 
ноль: ноль 
значение: значение 
патч: патчем патч патча 
терабайт: терабайтами 
глубокий: глубокого 
указать: указать 
драйвер: драйвера 
старый: старую 
количество: количество 
паддинга: паддинга 
соответствовать: соответствующей 
добавлять: добавляет 
пока: пока 
значительно: значительно 
мир: мире 
линус: линуса 
анализ: анализа 
файловый: файловых 
представлять: представляет 
обновление: обновления обновлений 
половина: половину 
комментарий: комментарии 
технология: технология технологиями технологии 
её: её 
отправка: отправке 
битый: бита 
сегментировать: сегментирует 
назад: назад 
разработчик: разработчики разработчик 
снизить: снизить 
перейти: перейти 
гбайт: гбайт 
голос: голосов 
закладка: закладки 
версия: версию 
примечательный: примечательных 
меню: меню 
называть: называемых 
похожий: похожие 
описать: описали 
вернуться: вернуться 
это: это 
модификация: модификации 
выполнение: выполнение 
многопутевой: многопутевой 
себя: собой 
цель: цели целей 
хабра: хабр 
производительность: производительность производительности 
апрель: апреля 
гиперскейлер: гиперскейлеров 
кбайт: кбайт кбайта 
размер: размер размером размера 
также: также 
кандидат: кандидатах кандидат 
первый: первую первые первым первый 
высокопроизводительный: высокопроизводительных 
внутренний: внутренних 
менее: менее 
говорить: говорим 
применять: применяют 
проблема: проблемы 
поддержка: поддержка поддержку 
сократить: сократить 
высокий: высоким 
час: часа 
вновь: вновь 
наш: нашем 
направление: направлениях 
рекомендация: рекомендации 
сеть: сетях 
агрегировать: агрегирует 
обновить: обновить обновлённые 
индикатор: индикатора 
фишка: фишек 
этот: эта этих 
рост: рост 
процессор: процессора 
время: время времени 
приемлемый: приемлем 
среда: средах 
провайдер: провайдеры 
язык: язык языка 
очередь: очереди 
скорее: скорее 
год: году 
крупный: крупных 
слово: словам 
оставаться: остается 
концепция: концепцию 
новый: новая новые новых 
использовать: использовали 
хаба: хабы 
составлять: составляют 
посылка: посылки посылок 
установка: установка 
просмотр: просмотров 
нововведение: нововведение нововведений 
публикация: публикации 
бенчмарка: бенчмарки 
взять: взять 
дополнение: дополнений 
регулятор: регуляторы 
сетевой: сетевому сетевые сетевыми 
обеспечение: обеспечения 
равно: равно 
стечь: стеку 
содержать: содержать 
давать: давать 
точный: точный 
миллион: миллионами 
хороший: лучшие 
сделать: сделать 
подход: подход 
мало: мало 
финальный: финальный 
гигабитный: гигабитных 
пользователь: пользователь 
идея: идея 
энтузиазм: энтузиазмом 
свитч: свитчей 
обработка: обработкой 
функциональность: функциональности 
дзен: дзен 
стандарт: стандарты 
торвальдс: торвальдса 
реальный: реальной 
максимальный: максимального 
умолчание: умолчанию 
сайт: сайт 
нужный: нужна нужен 
нулевой: нулевое 
битный: битное 
последующий: последующих 
трафик: трафика 
запланировать: запланирован 
темп: темп 
вычислительный: вычислительные 
один: одно 
выйти: вышел 
петабайт: петабайтами 
документация: документации 
сквоттинг: сквоттинге 
качество: качестве 
блок: блок 
мина: мин 
решение: решение 
поиск: поиск 
связанный: связанных 
обычно: обычно 
число: число 
тег: теги 
работа: работе 
карма: карма 
корпоративный: корпоративном 
сутки: сутки 
какой: каких 
дата: дата 
логика: логику 
развиваться: развиваются 
приходить: приходит 
прочтение: прочтение 
включить: включили 
например: например 
архитектура: архитектуры 
неделя: неделе 
поэтому: поэтому 
показать: показали 
несколько: несколько нескольких 
увеличение: увеличение 
компания: компании 
особенно: особенно 
сильный: сильнее 
чрезмерно: чрезмерно 
изменение: изменения 
пара: пару 
вообще: вообще 
реализация: реализацией 
настройка: настройка 
