страна: страны 
весь: весь 
джеффри: джеффри 
справочник: справочников справочник 
следовать: следовать 
том: томов 
цитата: цитаты 
курс: курсах курсу курс курсов 
конкретный: конкретную 
го: го 
смысловой: смысловые 
стивен: стивен 
охватить: охватить 
даглас: даглас 
некий: некий 
внимание: внимание 
яндекс: яндекс 
прочитать: прочитанное прочитать прочитанных 
метод: методы методов 
тьюринг: тьюринга 
эшер: эшер 
будущее: будущем 
доказать: доказал 
первоисточник: первоисточники 
мнимый: мнимого 
напрямую: напрямую 
каждый: каждой 
получать: получать 
комментарий: комментарии 
голос: голосов 
лексический: лексические 
исторический: исторический 
тема: темы тему 
меню: меню 
дэвид: дэвид 
доступный: доступный доступна 
гипотеза: гипотезы гипотеза 
автор: автор автором авторы автора 
старший: старших 
период: период 
составлять: составляющая 
издание: издание изданию 
далее: д 
часть: часть 
роберт: роберт 
конец: конце 
опубликовать: опубликованы 
другой: другим других 
пользовательский: пользовательских 
студент: студентам студентов 
часто: часто 
пугать: пугают 
книга: книги книгу книга книге книгах книг 
панюнина: панюнин 
добавить: добавить 
год: лет году 
неполный: неполная 
ответ: ответы 
зависеть: зависит 
частый: чаще 
ричесон: ричесон 
нужно: нужно 
оригинал: оригинала 
учебник: учебниках учебник 
промежуточный: промежуточной 
исправление: исправления 
требоваться: требуется 
язык: языка языке язык 
который: которые которых которого 
дзен: дзен 
мысль: мысли 
перевод: перевод переводах 
паттерн: паттерна 
тезис: тезисы 
момент: моменты 
семестр: семестра семестров 
концепция: концепциям 
поиск: поиск 
переводчик: переводчик переводчики переводчика 
использовать: использовать 
заодно: заодно 
петцольд: петцольд 
математик: математиков 
точность: точность 
карма: карма 
эйлер: эйлера 
андреев: андреев 
мера: мере 
популярный: популярной популярное 
содержать: содержит 
коллега: коллегами 
оптимизация: оптимизации 
беглый: беглое 
несколько: несколько 
написать: написать написаны написано 
настройка: настройка 
глава: глав главе главы 
адаптировать: адаптировать 
учить: учит 
научно: научно 
широкий: широкой 
художественный: художественные 
стать: статей 
прим: прим 
профиль: профиль 
пол: пол 
ссылка: ссылок 
писать: пишите пишет писал писать 
общепринятый: общепринятую 
формула: формула 
ошибка: ошибки ошибок 
плохо: плохо 
библиография: библиографию 
недоказуемость: недоказуемость 
чарльз: чарльз 
литература: литература литературы литературе 
канал: каналы канал 
рассмотреть: рассмотрены 
университет: университета 
код: кода 
старый: старую 
программирование: программирования 
сеть: сети 
алгоритм: алгоритмы 
важный: важны 
название: названием названия 
предмет: предметом 
встретить: встретить 
оригинальный: оригинальные 
сказка: сказки 
базис: базис 
это: это 
предложить: предложить 
множество: множеством множество множества 
применить: применить 
иметь: имеет 
новость: новостей 
посвятить: посвященная 
принцип: принципы 
поддержка: поддержка 
подписаться: подписаться 
гирлянда: гирлянда 
доложить: доложил 
дополнительный: дополнительной дополнительный 
альфред: альфреда 
равить: рави 
знание: знаний 
телеграм: телеграм 
опыт: опыт 
существование: существование 
предоставить: предоставленные 
результат: результат 
изучаться: изучается 
первый: первая первых первой 
дать: данной 
хаба: хабы 
ульмана: ульмана 
рамка: рамках 
отрицание: отрицание 
мочь: могу 
профессиональный: профессиональная 
математический: математическая математическом 
обращать: обращайте 
топология: топологии 
научный: научная научной 
подтверждать: подтверждают 
продолжение: продолжение 
читаемый: читаем 
учесть: учтены 
хороший: хороший лучшие 
нахина: нахин 
называть: называемая 
бах: бах 
идея: идеи 
исправлять: исправляют 
проблема: проблем 
введение: введении 
такой: такое 
накопить: накопив накопленные 
сборник: сборник 
плохой: плохой 
р: р 
обычно: обычно 
помнить: помните 
тег: теги 
уровень: уровень 
задание: задания 
прочтение: прочтение 
дополнять: дополняет 
н: н 
м: м 
гильберт: гильберта 
континуум: континуум 
разный: разные 
история: история истории 
неподготовленный: неподготовленного 
полезно: полезно 
ахо: ахо 
дополнение: дополнения дополнение 
издательство: издательство 
кроме: кроме 
переусложнить: переусложненный 
интерфейс: интерфейсов 
сколько: сколько 
стиль: стиля 
появляться: появляется 
таковой: таковой 
просто: просто 
публиковать: публикую 
оттолкнуть: оттолкнуть 
жемчужина: жемчужина 
казаться: кажется 
версия: версию 
чтение: чтения 
хотя: хотя 
сочетание: сочетание 
аналог: аналогов 
искусство: искусство 
написание: написания 
автоматический: автоматического 
переработать: переработаны 
повод: поводу 
также: также 
терминология: терминологию 
мыслить: мыслить 
сложность: сложность сложности 
недоказуемый: недоказуемо 
этот: эта 
лента: лента 
большинство: большинство 
тип: тип 
некоторый: некоторые 
подразумеваться: подразумевается 
достаточно: достаточно 
процесс: процесс 
инструмент: инструменты 
какой: какие 
высокий: высших 
крайний: крайней 
намереваться: намереваясь 
лекция: лекции 
читатель: читателя 
дж: дж 
отталкиваться: отталкивается 
мина: мин 
мощность: мощности 
дисграфия: дисграфии дисграфия 
ситуация: ситуацию 
сутки: сутки 
список: списки 
п: п 
ваш: вашу 
показывать: показывают 
грамматический: грамматические 
новый: новых новая 
контекст: контекст 
материал: материал материала 
коэн: коэн 
пункт: пунктов 
технология: технологии 
сказать: сказано 
рассуждать: рассуждать 
правило: правило 
наука: наука 
самопроверка: самопроверки 
служить: служит 
примерно: примерно 
выполнить: выполнен 
рейтинг: рейтинг 
изучение: изучения 
кнут: кнут 
выбрать: выбрать 
вы: вами 
эрвин: эрвин 
спустя: спустя 
больший: большую 
разработка: разработка 
слепо: слепо 
готом: готома 
технический: техническая технической 
ругать: ругают 
текст: тексте 
количество: количество 
перёв: перев 
математика: математики 
конгресс: конгрессе 
телеграмма: телеграмме 
понимание: понимания 
многогранник: многогранников 
учебный: учебный 
закладка: закладки 
простой: простой 
брать: берут 
рождение: рождение 
последний: последнее 
школьный: школьный 
гёдель: гёдель 
др: др 
черновик: черновики 
многотомник: многотомника 
похожий: похожие 
вернуться: вернуться 
прислать: присланные 
неточность: неточности 
изучать: изучают 
прата: прата 
вино: вина 
хабра: хабр 
зал: зал 
знакомство: знакомство 
любой: любой 
бывать: бывают 
коллекция: коллекция 
компилятор: компиляторы 
обновить: обновить 
дональд: дональд 
читальный: читальный 
время: время 
культурный: культурный 
готовый: готовый 
сведение: сведения 
основа: основе 
бесконечный: бесконечная 
просмотр: просмотров 
публикация: публикации 
упражнение: упражнения 
стандартный: стандартному 
проработанность: проработанность 
так: т 
второй: вторая второму 
предисловие: предисловии 
пояснять: поясняющие 
седжвика: седжвик 
приложение: приложением 
тидвелла: тидвелл 
половина: половина 
понимать: понимает 
раскрытый: раскрытой 
термин: терминов 
родный: родном 
быть: будут 
третий: третьему 
наоборот: наоборот 
фундаментальный: фундаментальные 
хофштадтер: хофштадтер 
общение: общения 
мир: мира 
любезно: любезно 
демонстрировать: демонстрируют 
методический: методический 
пример: пример 
сноска: сносок 
основной: основные 
мара: мар 
заложить: заложенных 
вместе: вместе 
дженифер: дженифер 
аудитория: аудитории 
коновалов: коновалов 
лично: лично 
