ваш: ваш ваши ваших 
свой: своего свой 
действие: действия 
кмк: кмк 
реализовать: реализовал 
давно: давно 
один: одного одну одно 
яндекс: яндекс 
вектор: вектора 
поскольку: поскольку 
сложный: сложны 
строка: строкой строку 
возможно: возможно 
срок: срока 
закрытый: закрытые закрытых 
изменить: изменил 
образ: образам образа образ образов образы 
разработать: разработал разработать 
добавление: добавления 
комментарий: комментарии 
риск: риски 
голос: голосов 
пропускаться: пропускаются 
написать: написал 
сертификат: сертификата сертификатом сертификаты сертификатов сертификат 
меню: меню 
различный: различные 
нигде: нигде 
сложиться: сложился 
часть: часть части 
чексумма: чексуммы чексумма чексумму чексуммам чексумм чексумме 
рестарт: рестарте 
сила: силу 
безопасность: безопасности безопасность 
часто: часто 
неактуальный: неактуален 
кластер: кластер 
мысль: мысль 
храниться: хранятся 
добавить: добавить 
хранить: хранит хранить 
помощь: помощью 
подпись: подписи подпись 
атака: атака 
нужно: нужно 
убирать: убирать 
проблема: проблему 
приемлемый: приемлемые 
париться: париться 
песочница: песочницы 
подлежать: подлежат 
итого: итого 
вид: виде 
сделать: сделать сделал сделаю 
инфраструктура: инфраструктуры 
другой: другими 
язык: языка язык 
который: которые который котором 
шаг: шаг 
идея: идея 
дзен: дзен 
итог: итоге 
защищать: защищает 
издержка: издержек 
поиск: поиск 
специфика: специфики 
использовать: использовать использовал 
забывать: забываем 
карма: карма 
хранилище: хранилища 
взгляд: взгляд 
работа: работы работа 
простота: простота 
приложение: приложений приложениях 
предоставить: предоставить 
простой: прост 
криптографический: криптографической криптографическая 
стандарт: стандартом 
принцип: принцип принципу 
продукт: продукты продукт 
выдать: выдать выдал 
информационный: информационной информационная 
далее: далее 
заключение: заключение 
объявить: объявлены 
настройка: настройка 
выпуск: выпуска 
хэш: хэша 
необходимо: необходимо 
обычный: обычных 
мощный: мощная 
измениться: изменится 
некоторый: некоторого 
профиль: профиль 
входить: входила 
разумеется: разумеется 
отдельный: отдельный отдельного 
следствие: следствие 
означать: означает 
доверенный: доверенному доверенным 
код: кода 
стать: стал станет 
реестр: реестре реестра реестр 
старый: старую 
публичный: публичную 
ключ: ключей ключа ключи 
защититься: защитится 
инженер: инженер 
подписать: подписанные подписал 
это: это 
тэг: тэгов тэг 
иметь: имеет имеем 
использование: использования использовании 
упустить: упустил 
любой: любую 
получение: получения 
поддержка: поддержка 
быть: е 
прочесть: прочтете 
ссылка: ссылку 
опыт: опыт 
уц: уц 
подписывание: подписывания 
повышать: повышает 
хаба: хабы 
средство: средствами 
требовать: требовали 
смысл: смысла 
взять: взять 
неймспейс: неймспейсе 
пользователь: пользователь 
сборка: сборки 
очевидный: очевидные очевидно 
решать: решает 
тэгу: тэгу 
пренадлежность: пренадлежность 
качество: качестве 
полагаться: полагается 
слишком: слишком 
создавать: создает 
тег: теги 
клиент: клиентах 
уровень: уровень 
прочтение: прочтение 
например: например 
префикс: префикс 
понимать: понимал 
куча: кучу 
компания: компании 
реальный: реальную 
автоматизированный: автоматизированного 
специалист: специалист 
нюанс: нюансов 
запустить: запустит 
обрезать: обрезал обрезанного 
проверка: проверки 
независимость: независимость 
ручной: ручного 
источник: источника 
манифест: манифест 
искать: ищет 
проверять: проверяет 
сколько: сколько 
валиден: валиден 
просто: просто 
обратный: обратную 
положить: положить 
разработчик: разработчикам разработчиков 
выдавать: выдает 
назад: назад 
установить: установлен 
затем: затем 
версия: версию 
инструмент: инструмента инструмент 
невозможность: невозможность 
пометить: пометить 
также: также 
переменный: переменную 
получиться: получилась 
менять: менять 
исследовалиться: исследовались 
запускаться: запускались запускается 
история: истории 
понять: понял 
неоднократно: неоднократно 
вольный: вольны 
средний: средний 
увидеть: увидел 
верификация: верификации 
невежливый: невежливо 
слой: слой 
чарт: чарт 
хороший: лучшие 
оказаться: оказалось 
назвать: назвал 
хотеться: хотелось 
аналогично: аналогично 
оставаться: оставалось 
важный: важного 
следующий: следующем следующая 
вопрос: вопрос 
описать: описаны 
вебхук: вебхук 
паттерн: паттерны 
мина: мин 
эквивалентный: эквивалентным 
прелесть: прелести 
сутки: сутки 
брать: берет 
крутиться: крутилась 
самый: самая 
п: п 
заключаться: заключалась заключается 
скрипт: скрипт 
иначе: иначе 
остальной: остального 
вакансия: вакансии вакансий 
запись: записи 
выполнить: выполнена 
вредоносный: вредоносного вредоносное 
компрометация: компрометации 
хранение: хранение 
удобный: удобный 
позаимствовать: позаимствовал 
запрос: запроса 
информация: информации 
рейтинг: рейтинг 
отсчитывать: отсчитывать 
архитектура: архитектура 
невежство: невежства 
технический: техническая 
сложно: сложно 
полностью: полностью 
отсутствие: отсутствие 
добавлять: добавлять 
количество: количество 
пазл: пазл 
пока: пока 
развивать: развивать 
требоваться: требовалось 
удостоверение: удостоверения 
закладка: закладки 
похожий: похожие 
внедрение: внедрение 
вернуться: вернуться 
хабра: хабр 
снижать: снижает 
таки: таки 
сложность: сложности 
сразу: сразу 
обновить: обновить 
время: время 
стойкость: стойкость 
параметр: параметр 
просмотр: просмотров 
отозвать: отозвать 
валидация: валидация валидации 
публикация: публикации 
решение: решения 
так: т 
джоб: джобы 
вслепую: вслепую 
запускать: запускает 
работать: работала 
дополнительный: дополнительный 
случай: случае 
символ: символов 
создание: создания 
час: часов 
решить: решил 
установка: установки 
вообще: вообще 
мочь: можете 
серт: серт 
минус: минусы 
