порт: порт порты порта 
игра: игры игре игр 
вывод: вывод выводы выводами 
простой: простые 
область: области 
одинаковый: одинаковые 
последовательный: последовательный 
записать: записать 
один: одного 
разработка: разработки 
перезагрузка: перезагрузки 
ммс: ммс 
яндекс: яндекс 
приобрести: приобрести 
оперативный: оперативной оперативная 
значение: значение значения 
возможно: возможно 
память: памяти память памятью 
мапперо: маппером маппера 
консоль: консоли 
право: права 
переключать: переключаемых переключать переключаемый 
общий: общей общие общем общий 
функция: функция функции функций 
картридж: картридже картридж 
комментарий: комментарии 
голос: голосов 
состояние: состояния 
пзу: пзу 
анимация: анимации анимация 
страница: страницу странице страницы страница страницах страниц 
меню: меню 
должный: должны должна должно 
сохранение: сохранениями сохранения 
связанный: связанные 
указатель: указатель 
увеличить: увеличить 
дать: данная данные 
правда: правда 
микросхема: микросхемами микросхемы 
порядок: порядок 
дело: деле делом 
заработать: заработал 
последовательно: последовательно 
добавить: добавить добавлено 
адрес: адреса адрес 
флаг: флаги 
использовать: использовали использовать использующие 
сам: самом 
помощь: помощью помощь 
рассмотреть: рассмотрим 
вызов: вызов 
такой: такие такое такая 
нужно: нужно 
пример: примеру 
битый: бит 
смена: смены смена 
иметь: имеют имеет 
небыть: небудет 
перейти: перейдем 
получать: получаем 
ассемблер: ассемблер 
язык: языка язык 
который: которые которая который 
переключаться: переключаться 
схема: схема 
дзен: дзен 
сегмент: сегменты 
гипотетический: гипотетический 
регистр: регистров регистра регистры регистр регистрами 
цель: целей 
зеркалирование: зеркалирование зеркалирования 
корректно: корректно 
эмулятор: эмуляторе эмуляторам 
загрузка: загрузки 
расположить: расположены 
собственно: собственно 
поиск: поиск 
разбить: разбить 
существовать: существует 
программный: программного 
лишь: лишь 
статус: статусов 
код: кодом кода код коде 
карма: карма 
батарейка: батарейка батарейках 
организация: организацию организация 
содержать: содержит 
управление: управления 
храниться: храниться 
несколько: несколько 
далее: далее 
следующий: следующую следующие следующая 
сделать: сделал 
интегральный: интегральная 
сегодня: сегодня 
настройка: настройка 
два: двумя 
необходимо: необходимо 
подавать: подаваемые 
профиль: профиль 
прерывание: прерывания 
пожелание: пожеланиями 
питать: питала 
миграция: миграции 
развитие: развитием 
основный: основное 
банк: банк банка банков банки 
вводный: вводная 
ссылка: ссылки 
старый: старую 
сдвиг: сдвига 
использование: использованию использования 
графика: графика графики графикой 
битов: битов 
наличие: наличие 
ходить: ходить 
обратиться: обратиться 
теория: теорию 
заполнить: заполнены 
это: это 
самый: самых самым 
команда: команды 
говорить: говорим 
указанный: указанная 
поддержка: поддержка 
хранилище: хранилище 
тот: та 
прокрутка: прокрутка 
запуск: запуске 
хаба: хабы 
браться: берется 
свой: своих своем 
маппер: маппер 
переключить: переключить 
серийный: серийные 
согласиться: согласитесь 
восстановление: восстановления 
знать: знать 
кб: кб 
пользователь: пользователь 
умолчание: умолчанию 
процедура: процедура процедуру процедуры 
нужный: нужна 
первый: первое первой первым 
сократить: сократил 
проект: проект проекта проекте 
качество: качестве 
стать: станет стать 
выбрать: выбрал 
принцип: принципе 
важный: важное 
палитра: палитры 
тег: теги 
соответствие: соответствие 
уровень: уровень уровнями 
конфигурация: конфигурация конфигурацией конфигурации 
прочтение: прочтение 
прежде: прежде 
блокировать: блокирует 
компилировать: компилируем компилировать 
флёша: флеш 
зафиксировать: зафиксирован зафиксированный 
байт: байт 
подобие: подобие 
статья: статья 
встать: встал 
около: около 
ограничить: ограничены 
подготовить: подготовили 
замечание: замечаний замечание 
вокруг: вокруг 
включать: включает 
наш: нашего наш нашей нашем нашими 
начальный: начальный 
способный: способен способны способная 
младший: младший 
хороший: хорошие лучшие 
ибо: ибо 
запись: запись записи 
исходить: исходя 
прописать: прописать 
момент: моментов 
некоторый: некоторых 
железа: железе 
тестирование: тестирования 
просто: просто 
канал: канал 
герой: героя 
всё: всё 
прислать: пришли 
вертикальный: вертикальное 
полезный: полезные 
назад: назад 
версия: версию 
реальный: реальном 
понять: понять 
упрощённый: упрощенный 
упоминать: упоминал 
мапперы: мапперы 
данный: данного 
менять: менять 
увидеть: увидим 
файл: файла файлы файл 
мы: нам 
линкер: линкера 
процессор: процессора 
хотеться: хочется хотелось 
история: истории 
я: мной 
вызывать: вызываем 
средний: средний 
комментировать: комментировать 
создание: создание 
считывание: считывание 
недоставать: недостающие 
появиться: появиться 
новый: новые 
имплементация: имплементация 
лёт: лету 
соединять: соединять 
вектор: векторе векторы 
импортировать: импортируем 
вопрос: вопрос 
документация: документации 
сбросить: сбросить 
диапазон: диапазона 
мина: мин 
сменить: сменить 
работать: работает работать 
сутки: сутки 
соответсвенный: соответсвенно 
специальный: специального 
инициализация: инициализации 
сложный: сложных 
мой: мое 
фиксировать: фиксированной 
изменение: изменения 
перенаправить: перенаправлено 
назначение: назначения 
выше: выше 
режим: режим 
вещь: вещи 
общение: общению 
фон: фона 
последний: последней последним 
примерно: примерно 
немного: немного 
перезаписывать: перезаписываемой 
рейтинг: рейтинг 
й: й 
теряться: терялись 
получиться: получиться получившиеся 
атрибут: атрибутов 
враг: врагов 
технический: техническая 
находиться: находиться 
сложно: сложно 
отсутствие: отсутствие 
количество: количество количестве 
репозиторий: репозиторий 
пока: пока 
вариант: вариантов 
пункт: пункт 
либо: либо 
спрайт: спрайтов 
довольно: довольно 
написать: написаны 
закладка: закладки 
программирование: программирование 
похожий: похожие 
вернуться: вернуться 
многие: многие 
дописать: дописать 
хабра: хабр 
знакомство: знакомство 
программа: программы 
любой: любой 
сложность: сложности 
выполнить: выполнить 
долго: долго 
секция: секции 
близкий: ближайшее 
заголовок: заголовки 
устанавливать: устанавливаю 
обновить: обновить 
разобраться: разобраться 
использоваться: используется 
время: время 
значит: значит 
просмотр: просмотров 
публикация: публикации 
тестироваться: тестировалось 
встроить: встроена 
переименовывать: переименовываем 
заключение: заключения 
отличие: отличие 
они: ними 
быть: будут 
ограничение: ограничения 
работа: работе 
хотеть: хочу 
собрать: собрать 
сказать: сказать 
горизонтальный: горизонтальное 
подменять: подменять 
час: часов 
разобрать: разберем 
контроллер: контроллера 
ве: ве 
левый: лево 
