логика: логика 
структура: структура структуры структуре структурой 
извлечение: извлечения 
присвоить: присвоим 
вывод: вывод 
профессиональный: профессионального профессиональное 
являться: является 
путём: путем 
переложить: переложить 
один: одного одном одна одной 
допустить: допустим 
яндекс: яндекс 
поскольку: поскольку 
датасет: датасет датасете датасета датасеты датасетом 
обусловить: обусловлен 
смотреть: смотрим 
незнакомый: незнакомы 
второе: второе 
итог: итоги 
общий: общей 
полный: полной 
бессчётный: бессчётное 
строка: строка строк 
представлять: представляет представляющий 
прикрепить: прикрепил 
комментарий: комментарии комментариях 
первичный: первичные 
издательство: издательства издательство 
следить: следим 
голос: голосов 
упрощённый: упрощенным 
удача: удачи 
меню: меню 
автор: автор авторы авторов авторами 
команда: командой команде 
связанный: связанные связанных 
далее: д 
задача: задача 
статья: статьей статьями статья 
библиотека: библиотеку 
размер: размер размером 
сырой: сырой 
оставить: оставил 
дело: деле 
преобразование: преобразование преобразовании 
порядок: порядка 
добавить: добавить 
откуда: откуда 
однако: однако 
естественно: естественно 
сам: самом 
подписчик: подписчиков 
такой: такие таким 
нужно: нужно 
таблица: таблиц таблицу таблицы таблицами 
затратить: затраченное 
вид: виде вид 
пара: пары пар 
сделать: сделать 
язык: языка язык 
этот: этими эта этих 
создаваться: создаётся 
дзен: дзен 
ожидаться: ожидалось 
каждый: каждому каждого 
нарушить: нарушен 
корректно: корректно 
слабоструктурировать: слабоструктурированные слабоструктурированы слабоструктурированными 
версия: версией версию 
символьный: символьного 
нормальный: нормальную 
поиск: поиск 
уникальный: уникальной уникальный 
зрение: зрения 
использовать: использовать 
отношение: отношения 
документоориентировать: документоориентированной 
однозначно: однозначно 
издание: издания изданиями 
карма: карма 
дата: дата 
взгляд: взгляд 
участник: участник 
адаптация: адаптации 
работа: работы работа 
страница: странице 
выровнять: выровнять 
разбивать: разбиваем 
храниться: храниться 
специфика: специфику 
анализировать: анализируем 
генерация: генерации 
оформить: оформлены 
следующий: следующую следующей следующего 
настройка: настройка 
привет: привет 
адаптировать: адаптировать 
необходимо: необходимо 
группа: группам 
стать: статей 
связь: связи связь 
разбивка: разбивкой 
профиль: профиль 
нормализовать: нормализовать нормализуем 
правильно: правильно 
палец: пальцах 
красноречивый: красноречиво 
тот: тех той 
сталкиваться: сталкиваемся 
реляционный: реляционной реляционные реляционный реляционных 
уровень: уровне 
сыр: сыром 
старый: старую 
значительно: значительно 
баланс: баланс 
создавать: создаём 
её: её 
показать: покажу 
это: это 
сигнализировать: сигнализирует 
издатель: издателей 
описывать: описывал 
ознакомиться: ознакомиться 
знание: знание 
запись: записях записи 
интегрировать: интегрируем 
редактор: редактор 
поддержка: поддержка 
который: которой которых который 
функционал: функционал 
продемонстрировать: продемонстрировать 
инженер: инженера 
почему: почему 
дать: данной 
позволять: позволяет 
потребоваться: потребуется 
хаба: хабы 
приводить: привожу 
описание: описания 
сущность: сущности сущностями сущностей 
рассказать: расскажу 
синтаксис: синтаксис 
образ: образом 
звать: зовут 
внутри: внутри 
проверка: проверками проверка 
читаемый: читаем 
время: времени время 
доп: доп 
целиком: целиком 
плоский: плоской 
объяснение: объяснением 
первый: первое первый первую 
неясно: неясно 
пояснение: пояснения 
сообщество: сообщества сообщество 
тег: теги 
ниже: ниже 
структурный: структурной 
оказываться: оказывается 
млн: млн 
прочтение: прочтение 
обработка: обработку 
происходить: происходить 
иметь: имеем 
легко: легко 
извлечь: извлечь 
формат: формате формат 
сильно: сильно 
трансформировать: трансформировать 
образовать: образовать 
уникальность: уникальность 
ошибка: ошибка 
форма: форму 
ровно: ровно 
решить: решено решив 
около: около 
термин: термины 
качество: качество 
читать: читать 
думать: думал 
кстати: кстати 
контекст: контексте 
данный: данном 
чётко: чётко 
ключ: ключи 
принять: приняла 
недостаток: недостаток 
особый: особой 
гб: гб 
реализовать: реализую 
невалидный: невалидные 
насколько: насколько 
разведочный: разведочный 
верхний: верхнем 
проверять: проверяет 
сколько: сколько 
некоторый: некоторых 
ненормализованный: ненормализованным 
описать: описанной описать 
навык: навыков 
нормально: нормально 
атрибут: атрибуты атрибутов 
извлекать: извлекаем 
раскрывать: раскрываем 
казаться: кажется 
конкретный: конкретной 
хотя: хотя 
применяться: применяется 
наш: нашей 
понять: понять 
соответствовать: соответствовать соответствует 
составить: составленного 
пользоваться: пользоваться 
столбцы: столбцы столбцов 
подготовить: подготовленные 
сократить: сократить 
преобразовать: преобразуем 
файл: файла файл 
столкнуться: столкнуться 
мы: нам 
история: истории 
дублирование: дублирование дублирования 
потребность: потребности 
оставаться: остается 
точка: точки 
достаточно: достаточно 
анализ: анализ 
пренебрегать: пренебрегать 
смоделировать: смоделировать 
придерживаться: придерживаемся 
соседний: соседних 
хороший: лучшие 
выбор: выбор 
отдельный: отдельные отдельным 
прийтись: пришлось 
вчера: вчера 
ранее: ранее 
жеронкина: жеронкин 
заточить: заточена 
отразить: отразить 
сайт: сайт 
значение: значений 
целое: целом 
представить: представить 
мина: мин 
недоставать: недостающих 
спокойно: спокойно 
целостность: целостностью 
залить: залить 
работать: работает 
сутки: сутки 
другой: другая 
скрипт: скрипт 
разработчик: разработчик 
текстовый: текстовый 
функция: функцию функций 
исключить: исключить 
пункт: пунктов 
остальной: остального 
использоваться: использоваться 
кейс: кейс 
скобка: скобками скобок 
вакансия: вакансии вакансий 
выше: выше 
хранение: хранение 
данные: данных 
впечатляющий: впечатляющий 
стоять: стояла 
рейтинг: рейтинг 
словарь: словарь 
обойти: обойти 
далёкий: дальше 
технический: техническая 
сложно: сложно 
больший: большим 
количество: количество 
дополнительно: дополнительно 
подвести: подведем 
требоваться: требовалось 
дополнительный: дополнительную дополнительный 
гораздо: гораздо 
список: списков 
закладка: закладки 
простой: простой 
нф: нф 
написать: напишем 
программирование: программирование 
действие: действий 
поспорить: поспорить 
слово: слово 
впечатление: впечатление 
похожий: похожие 
вернуться: вернуться 
выдержка: выдержку 
многие: многие 
картинка: картинкой 
хабра: хабр 
код: код 
любой: любой 
выполнить: выполнить 
сразу: сразу 
момент: момент 
проект: проекте 
переделывать: переделывать 
позволить: позволит 
обновить: обновить 
сохранить: сохранить 
два: две 
вызов: вызовам 
вложить: вложенных 
заранее: заранее 
валидный: валидный 
обработать: обработан 
провести: провести 
просмотр: просмотров 
параметр: параметр 
стоить: стоит 
отметить: отмечу 
публикация: публикации 
встречаться: встречающиеся 
так: т 
привести: привёл 
контролировать: контролировать 
выявить: выявила 
загрузить: загрузить 
ключевой: ключевое 
половина: половина 
они: ними 
антон: антон 
быть: будут 
чанк: чанкам 
достаточный: достаточных 
подгружать: подгружать 
попробовать: попробуем 
занять: займет 
пример: пример 
форматировать: форматированы 
многий: многим 
нужный: нужный 
новый: новой 
субд: субд 
поставляться: поставляются 
к: ко 
