страдать: страдают 
манипулировать: манипулируют 
процесс: процессы процессе процессами процессом процесс процессов процессах процесса 
мочь: могут могли 
конкретный: конкретный конкретная конкретном конкретного 
социально: социально 
минимизировать: минимизируем 
управление: управление управления управлением 
задача: задачи задача задач задачах задачу задачами 
биотехнологический: биотехнологическая биотехнологической 
виртуальный: виртуальные виртуального 
приложение: приложения приложением 
промышленный: промышленными 
планировать: планирует 
различный: различных различные различным различное 
позволить: позволило 
непосредственный: непосредственного 
конечный: конечной 
задать: заданное заданных заданному 
коэффициент: коэффициентах коэффициенты коэффициентов коэффициента 
большой: большой большого большое 
ответ: ответ 
регулярный: регулярной 
применение: применения применение 
система: системой система системы систему систем 
поток: потоков 
влиять: влияет влияем 
область: области область 
являться: является являются 
клетка: клетки клеток 
жизна: жизн 
сервис: сервиса сервисов сервисами сервис сервисы сервисе 
препарат: препаратов препарата 
имитировать: имитировать 
привести: привели привести 
настройка: настройкой настройка настройки 
давно: давно 
один: одного одной 
разработка: разработки разработкой разработке разработка 
допустить: допустим 
яндекс: яндекс 
газ: газов 
коллега: коллег коллеги 
передавать: передают 
поскольку: поскольку 
технология: технологий технологии 
заменяться: заменяется 
какой: какими какому каких какие 
оперативный: оперативной 
значение: значение значения значений значением 
реактор: реактор реакторов реакторе реактора реакторах 
производственный: производственной производственные производственных 
литр: литра 
успешно: успешно 
рассказать: рассказать 
режим: режиме режима 
смотреть: смотрим 
средство: средств средства 
финансовый: финансовые 
исследование: исследований исследованиями исследования 
ят: ят 
желаемый: желаемого 
индустрия: индустрии 
сам: самого 
активный: активны активных 
итог: итоги 
повышение: повышения 
устанавливать: устанавливаем 
получать: получать 
функция: функция функции функций 
плоскость: плоскости 
полный: полной полного 
мастер: мастер 
комментарий: комментарии 
пользователь: пользователям пользователь пользователями 
кислотность: кислотности кислотность 
голос: голосов 
множество: множестве множество множества 
обеспечение: обеспечение 
состояние: состояния 
замедляться: замедляется 
сфокусировать: сфокусирована 
дукт: дукт 
реальный: реальные реальному реальном реальной реального 
классик: классик 
выходной: выходное 
лекарственный: лекарственные лекарственных 
количество: количества количество количестве 
меню: меню 
взаимосвязь: взаимосвязь взаимосвязям 
крупный: крупной крупных 
концентрация: концентрации 
тот: тому той 
широкий: широким 
гипотеза: гипотезы гипотез 
посмотреть: посмотреть 
беспилотный: беспилотных 
влечь: влечет 
далее: д 
контроль: контроля 
логирование: логирования логирование 
пуско: пуско 
улучшение: улучшения 
часть: часть частей части 
наступление: наступления 
машинный: машинного машинное машинном 
онкология: онкология 
база: базе 
проведение: проведении проведение проведением проведения 
материальный: материальные 
соблюсти: соблюсти 
дать: данная данной данному данные дать 
пайплайна: пайплайны пайплайну пайплайн 
именно: именно 
производство: производствах производство производства производстве производств 
выйти: вышедшие 
поведение: поведение поведения 
датчик: датчику датчика датчики датчик датчиков 
экономить: экономить 
часто: часто 
регулирование: регулирования 
существенно: существенно 
допустимый: допустимых 
учитывать: учитывать учитывающих 
последующий: последующим последующей 
вручную: вручную 
эксперимент: экспериментов эксперименты 
участвовать: участвуют участвует 
изменение: изменению изменениям изменения изменение 
подпитка: подпиток 
среда: среду среде 
такой: такими таким таких 
нежелательный: нежелательным 
связывать: связывает 
настроить: настроено 
решение: решением решениях решение решения решении 
порядок: порядка 
больший: большее 
запуск: запуск запуске 
добавить: добавить 
правило: правила правил 
год: лет году 
точно: точно 
хранить: хранит 
биологический: биологическом биологических 
частый: чаще 
знание: знания 
исполнение: исполнение 
помощь: помощью помощи 
уравнение: уравнения уравнение уравнением уравнению 
оценка: оценке 
департамент: департамента 
сложность: сложностей сложность 
развитие: развитии развития развитием 
проблема: проблему проблема проблем проблемой 
продвижение: продвижением 
ганизм: ганизм 
ход: ходе 
иметь: имеют иметь 
одинаково: одинаково 
внедрение: внедрением внедрение 
определённый: определенную определенных 
оборудование: оборудованием оборудования 
построение: построение построении построению построением построения 
вид: виде виды 
реакция: реакции реакцией реакция 
инновационный: инновационные 
простой: проще простым 
сделать: сделать 
цифровой: цифровых цифрового цифровой цифровые 
другой: другими другие другое других 
получаться: получается 
мых: мых 
который: которые которая которых который которую которого 
язык: языка языке язык 
метод: метод методов 
требовать: требует 
дзен: дзен 
прод: прод 
продукт: продуктов продукт продукта продуктам 
воздействие: воздействие 
автоматизация: автоматизацию автоматизации 
модель: моделями модель моделях моделей модели 
электроника: электроники 
менять: меняя менять 
надёжный: надежными 
наш: нашим нашего наш наши нашей наших нашем 
надеяться: надеемся 
момент: моменты 
стоимость: стоимость 
уд: уд 
аутоимунный: аутоимунные 
автомобиль: автомобилях 
необходимый: необходимой необходимы необходимое 
регулировать: регулируемой 
поиск: поиск поиском поиску 
коробочный: коробочные 
шифт: шифта шифт 
двойник: двойников двойники двойник двойника 
уволить: уволили 
мониторинг: мониторинга 
использовать: использовать используем используя 
полнота: полноту 
редкий: редких 
ды: ды 
разбить: разбить 
перспектива: перспективе 
существовать: существует существуют 
белок: белков белка белок 
птимальный: птимальная 
парный: парные 
второй: втором второй второго вторая второму 
подходящий: подходящего 
реализация: реализации 
график: график 
испытывать: испытывают 
карма: карма 
скользящий: скользящих 
доверять: доверять 
генетический: генетических 
корректироваться: корректируются 
ускорить: ускорить 
рубль: рублей 
проект: проектах проект проектов проекты 
событие: событий 
результат: результате результат результатов результаты 
работа: работы работу работ работой работе 
цель: целью цели цель 
обучение: обучения обучении обучение обучением 
данные: данным данными данных 
операционный: операционной 
подача: подачами подачи 
зона: зону 
регулятор: регулятор регулятора 
программный: программной 
оптимизация: оптимизации оптимизацией 
промежуток: промежуток 
генерация: генерации 
физико: физико 
написать: написать 
направление: направлений направлениях направления 
продукция: продукции 
смежный: смежных 
ускорение: ускорения 
биореактор: биореакторах биореакторов биореактора биореактором биореактор биореакторе биореакторы 
математический: математических математические 
проектировать: проектирует 
культ: культу 
кислый: кисл 
привет: привет 
выделить: выделен выделили 
устанавливаться: устанавливаются 
включать: включать 
научно: научно 
возникать: возникает 
нарастить: нарастить 
необходимо: необходимо 
подвергаться: подвергаются 
перерегулирование: перерегулирования перерегулирование 
асутп: асутп 
цифровизация: цифровизацию 
счастливый: счастливы 
серия: серии 
избежать: избежать 
связь: связи 
ащивания: ащивания 
отбор: отборе 
предсказание: предсказания 
профиль: профиль 
оператор: операторы оператора 
зависимость: зависимости 
рассказ: рассказ 
неделя: неделями 
маленький: маленький 
бизнес: бизнесу бизнеса бизнесе бизнес 
переходной: переходной 
корректный: корректные корректного 
моделирование: моделирование моделирования 
этап: этапом этапе этапа этапы этап 
важный: важнейшими 
устройство: устройств устройство 
сталкиваться: сталкиваемся 
собирать: собирает 
алгоритм: алгоритмов алгоритмами алгоритм 
компромисс: компромисса 
начальный: начальные 
сущий: сущ 
считаться: считаются 
биомасса: биомасса 
добавляться: добавляется добавляются 
качество: качества качестве качество 
решаться: решается 
потеря: потере потери 
значимый: значимых значимыми 
резкий: резкое 
код: кода код 
б: б 
старый: старую 
программирование: программирования 
свой: своему свое 
рабочий: рабочая рабочий рабочих 
распространение: распространение 
невозможно: невозможно 
предыдущий: предыдущие предыдущих 
сесть: сесть 
эффективный: эффективным 
жизненный: жизненным жизненного 
анализ: анализом анализ 
полнофункциональный: полнофункционального 
актуальный: актуальные 
трудоёмкий: трудоемкими 
лизм: лизма 
создание: созданию созданием создания 
сбивать: сбиваем 
упрощать: упрощает 
молекула: молекулы 
уровень: уровня уровнях 
дифференциальный: дифференциальным дифференциальное дифференциального 
усл: усл 
отклонение: отклонения 
основный: основных 
условие: условия 
снижение: снижению снижения 
визуализироваться: визуализируются 
писать: пишут пишет 
искать: ищут 
хороший: наилучших лучшие хорошего 
это: это этим 
нт: нт 
аналитический: аналитическую 
первый: первого первая первый первой 
исторический: историческим исторические исторических 
тест: тестов 
первоначальный: первоначальным 
нехватка: нехватки 
использование: использования использование использованием 
узкий: узкая 
команда: команды команде команда 
выпустить: выпустить 
эффект: эффектам 
целевой: целевых 
получить: получил полученные 
получение: получения 
продя: проде 
поддержка: поддержка поддержкой поддержку поддержки 
предварительный: предварительной 
установка: установке 
деталь: детали 
температурный: температурный температурного 
применять: применяем 
портфель: портфель 
стыдно: стыдно 
продакшен: продакшене 
расхождение: расхождения 
передать: передать 
показать: показать 
нестабильность: нестабильность 
позволять: позволяет позволяют позволяя 
очередь: очередь 
повышать: повышает 
одноточечный: одноточечных 
хаба: хабы 
достижение: достижении 
разбираться: разбирается 
качественный: качественные 
исследовательский: исследовательских исследовательские 
таб: таб 
пиво: пиво 
оборудовать: оборудовать 
выгода: выгоде 
интернет: интернета 
создать: создали создать 
заниматься: занимается занимаемся занимаются 
показатель: показателям 
получиться: получилось 
образ: образом 
протокол: протоколами 
формироваться: формируется 
говорить: говорил 
сильный: сильная 
время: времени время 
тся: тся 
попробовать: попробовали 
обязать: обязан 
строй: строя 
сотрудник: сотрудники 
устойчивость: устойчивости 
современный: современных современный 
решать: решает решаем решать решают 
процедура: процедура 
происходить: происходит 
коммерческий: коммерческой 
минута: минуты 
полноценный: полноценного 
признак: признаков 
добавка: добавок 
переход: переход перехода 
превышать: превышает 
предсказывать: предсказывать 
растворить: растворенного растворенный 
хотеть: хотим 
создавать: создает 
кл: кл 
тег: теги 
подбор: подбор 
самочувствие: самочувствия 
цикл: цикла циклом 
находить: находит 
закончить: закончить 
ресурс: ресурсы ресурсов 
научный: научные 
ценность: ценности ценность 
дача: дача 
неочевидный: неочевидным 
прочтение: прочтение 
промежуточный: промежуточный 
например: например 
технолог: технологи 
отсутствовать: отсутствуют 
м: м 
передаваться: передается 
контролировать: контролирует 
аналогичный: аналогичных аналогична 
оно: оно 
сбор: сбора сбором 
поэтому: поэтому 
повторяться: повторяется 
разный: разные 
история: история 
максимально: максимально 
компания: компании компания 
извлечь: извлечь 
повлиять: повлиять 
непосредственно: непосредственно 
вопрос: вопросами 
подверженный: подвержен 
несколько: нескольких несколькими 
технологический: технологических технологического технологическими технологический 
стратегия: стратегии 
размножаться: размножаться 
расчёт: расчета 
азмн: азмн 
протяжение: протяжении 
тестирование: тестированием 
объект: объекту 
состоять: состоять состоит 
проверка: проверки проверка 
лаборатория: лабораторий 
около: около 
путь: путь 
очень: очень 
фреймворк: фреймворка 
производный: производной 
контекст: контексте 
структурировать: структурирует 
кроме: кроме 
неопределённый: неопределенный 
сводиться: сводится 
информация: информацией 
тренд: трендов 
польза: пользу 
элемент: элемент 
пытаться: пытается пытаемся 
сформироваться: сформировалась 
насыщ: насыщ 
приводить: приводит 
план: планы 
оказывать: оказывают 
исходить: исходя 
запустить: запущен запущенного запустить 
диапазон: диапазонах 
оптимальный: оптимальных 
терапия: терапии 
последствие: последствий 
продолжительный: продолжительной 
настоящий: настоящее 
прогнозирование: прогнозирование прогнозированию 
выбрать: выбран выбрали 
решить: решить 
круг: круг 
вставить: вставлены 
комлпекс: комлпексов 
доменный: доменных 
выход: выхода выход 
временной: временными 
течение: течением 
характеристика: характеристикой 
эффективность: эффективность эффективности 
небольшой: небольших небольшое 
типичный: типичной 
дельта: дельты 
отправляться: отправляются 
подход: подхода подходы 
установиться: установившееся 
всё: всё 
размножение: размножения 
ряд: рядами 
поддержание: поддержания поддержании 
предложный: предложен 
вия: виях 
рассылаться: рассылаются 
затем: затем 
версия: версию 
хотя: хотя 
управлять: управляют управляющее 
доставить: доставить 
начинаться: начинается 
перемещаться: перемещается 
следующий: следующий следующая 
гейтвеять: гейтвей 
абсолютный: абсолютного 
использоваться: используются использоваться 
невозможность: невозможность 
утечка: утечки 
метрика: метрик 
сокращение: сокращения 
подводить: подводят 
распространить: распространенная 
также: также 
отслеживание: отслеживанием 
серьёзный: серьезной 
превратить: превратить 
менее: менее 
производиться: производятся производится 
многопоточный: многопоточным 
работать: работают работаем работает 
долгосрочный: долгосрочной 
иметься: имеющихся 
рекомендация: рекомендация 
низкоуровневый: низкоуровневые 
приблизить: приблизят приближено приближенные 
наиболее: наиболее 
полноценно: полноценно 
лабораторный: лабораторном лабораторных 
этот: эта этих 
мы: нам 
развлекаться: развлекается развлекаются 
вести: ведет 
мик: мик 
представление: представление 
знакомый: знакомых 
опираться: опираясь опираться 
фармацевтика: фармацевтика 
новый: новейшие новые новых 
достигнуть: достигли достигнуть 
ствля: ствля 
тип: тип 
накладывать: накладывают 
составлять: составляют 
параметр: параметры параметра параметров параметр 
градус: градуса градусов 
точка: точки 
обработка: обработке 
уставка: уставка уставки 
затратный: затратная 
сердце: сердцем 
лишить: лишен 
практически: практически 
смоделировать: смоделировать 
удаться: удалось 
выбор: выбор 
затруднять: затрудняет 
оказаться: оказалось 
прийтись: пришлось 
экспертный: экспертной 
неизвестный: неизвестные 
кислород: кислород кислорода 
возвращать: возвращая 
вчера: вчера 
взаимодействовать: взаимодействовать 
красный: красным 
объём: объему объем 
недостаточный: недостаточной 
затянуться: затянуться 
фактор: факторами 
соответствовать: соответствующее 
инструмент: инструментов 
свести: свели 
сайт: сайт 
стадия: стадии 
сбой: сбоев 
организация: организации 
целое: целом 
документация: документации 
зда: зда 
массовый: массового 
езона: езон 
мина: мин 
развёртывание: развертыванием 
выстраивать: выстраивает 
сложный: сложной сложнейших 
описывать: описывающих 
аппаратный: аппаратной 
аналитик: аналитиков 
вывод: вывода 
взаимодействие: взаимодействия 
избавиться: избавиться 
связанный: связанных связанными 
скачкообразный: скачкообразному 
маркетинговый: маркетинговой 
конвертер: конвертером 
сутки: сутки 
схожесть: схожести 
красивый: красивый 
самый: самая 
п: п 
риск: рисков 
затрата: затрат 
показывать: показывают показывает 
внедрять: внедряют 
соответствие: соответствии 
выходить: выходит 
подразделение: подразделений 
доклинический: доклинических 
определение: определения 
исследовать: исследуемых 
алгоритмический: алгоритмической 
табличный: табличными 
весь: всем 
длиться: длиться 
мама: маме 
ваня: вани 
уважение: уважением 
переключение: переключения 
физический: физическом физических 
заменить: заменили 
помогать: помогает 
квадрокоптер: квадрокоптерах 
углубляться: углубляясь 
функционал: функционалом 
уведомление: уведомления 
ситуация: ситуацией 
окно: окнам 
рецептурный: рецептурного 
явление: явление 
начинать: начинают 
нуждаться: нуждаются 
существующий: существующих 
служить: служит 
наслать: нашли 
ограниченный: ограниченных 
немного: немного 
рейтинг: рейтинг 
й: й 
гиперпараметр: гиперпараметров 
продолжать: продолжаем 
температура: температуре температуры 
стул: стул стула 
слово: слов 
длительный: длительными 
два: двух 
архитектура: архитектура 
замкнутый: замкнутый 
заболевание: заболеваний 
доступ: доступ 
эт: эт 
быстрый: быстрой 
отсутствие: отсутствием 
технический: техническая технической 
полезный: полезных 
обладать: обладает 
ния: ния 
общий: общий 
рынок: рынок 
облегчить: облегчить 
роль: роли 
дифференцирование: дифференцирования 
дополнительно: дополнительно 
группа: группа 
найти: найти 
артефакт: артефактов 
проверять: проверяют 
оптимизировать: оптимизировать 
линия: линии 
заключаться: заключается 
увеличивать: увеличивают 
очевидный: очевидна 
культивирование: культивирования 
закладка: закладки 
операция: операциями 
похожий: похожие 
вернуться: вернуться 
изучать: изучают 
человек: человек 
клинический: клинических 
обобщить: обобщить 
себя: собой 
льн: льн 
стресс: стресс 
хабра: хабр 
впервые: впервые 
проходить: проходит 
расходиться: расходиться 
продуктовый: продуктовый 
увеличение: увеличения 
сразу: сразу 
калибровка: калибровок 
культура: культур 
принести: принесут 
потенциально: потенциально 
специалист: специалисты 
требование: требования 
обновить: обновить 
значительный: значительный 
разобраться: разобраться 
логично: логично 
сти: сти 
изменить: изменена 
интегрировать: интегрированы 
настраиваться: настраиваются 
итеративный: итеративно 
заключительный: заключительной 
стабильный: стабильных 
основа: основе 
производить: производить 
считать: считает 
просмотр: просмотров 
бюджет: бюджетом 
необходимость: необходимости 
выноситься: выносится 
публикация: публикации 
засев: засева 
так: т 
расширить: расширить 
известный: известен 
переходный: переходных 
питат: питат 
отдыхать: отдыхает 
данный: данный 
подружить: подружили 
наладочный: наладочных 
вещь: вещей 
х: х 
постараться: постарались 
провести: проведя 
литровый: литрового 
они: ними 
заставить: заставить 
срок: срок 
вендор: вендоров 
клеточный: клеточных 
вещество: веществ 
текущий: текущее 
фактически: фактически 
отладочный: отладочных 
эксперт: экспертов 
показание: показания 
тайна: тайны 
блок: блок 
колебание: колебания 
вложение: вложения 
предобработка: предобработки 
пропорциональность: пропорциональности 
достигать: достигать 
скорость: скорость 
трудность: трудностей 
накапливаться: накапливается 
рост: роста 
влияние: влияния 
тв: тв 
случай: случае 
блог: блог 
ограничение: ограничений 
пример: пример 
основать: основан 
час: часов 
запускаться: запускается 
фармацевтический: фармацевтической 
пара: пару 
обусловить: обусловлена 
пациент: пациенты 
любой: любом 
к: ко 
