логика: логика 
рассылка: рассылки 
мочь: могут можем можете 
система: системе системой системы 
интересный: интересен интересное интересным интересного 
определяться: определяется 
версия: версиях версией версию версии 
вирус: вируса вирус 
модуль: модуль модули модулей 
опрос: опрос 
виртуальный: виртуальные виртуальной 
приложение: приложения приложение приложений приложениями 
статистический: статистического статистический 
исследователь: исследователи 
сперва: сперва 
различный: различных различные 
ступень: ступени ступеней ступень 
прочее: прочее 
видеть: видят видели видеть 
трудоустройство: трудоустройство 
внедрить: внедрить 
полезный: полезную полезная 
просмотр: просмотре просмотров 
второй: вторым второй второго вторая 
извлекать: извлекает 
защита: защите защитой 
распаковка: распаковки 
являться: является являются 
реестр: реестру реестре реестра реестр 
изменять: изменяющий изменяет 
путём: путем 
конфигурационный: конфигурационных 
дропперов: дропперов 
кража: кража краже 
читатель: читатель читателей 
злоумышленник: злоумышленники злоумышленником злоумышленник злоумышленнику злоумышленников 
бесплатный: бесплатными бесплатный 
администратор: администратора 
гидра: гидра гидру 
действие: действия 
светиться: светилась 
внимание: внимание 
знать: знают 
допустить: допустим 
атака: атаки атак 
яндекс: яндекс 
обработка: обработки 
поскольку: поскольку 
мой: моей моих моему 
динамический: динамического динамический 
простой: простая простое простыми простого простым простой 
значение: значение значениями значением 
эксплуатация: эксплуатация 
адаптер: адаптера 
килобайт: килобайта 
развёртывание: развертывание развертывания 
некоторый: некоторое некоторую 
документ: документ 
дро: дро 
обрисовать: обрисую 
напрямую: напрямую 
право: права прав 
подходить: подходит 
сам: самого самом сама 
активный: активны 
повышение: повышения 
клавиша: клавиш 
уязвимость: уязвимости уязвимость 
инцидент: инциденте 
анализ: анализа анализу анализ 
функция: функция функции функциям функцию функций 
представить: представлен представлена 
отправка: отправки отправка 
прерваться: прервалось 
представлять: представляет представляют 
комментарий: комментарии 
голос: голосов 
криптовалюта: криптовалютой криптовалюте криптовалюты 
очередной: очередной 
встретить: встретила встретить 
бывать: бывайте 
кодовый: кодовому 
воспользоваться: воспользуемся 
меню: меню 
пперы: пперы 
исходный: исходное исходным 
воздействие: воздействию 
автор: автор 
отвечать: отвечающий отвечает отвечающая 
позволять: позволяющей позволяет 
лишить: лишено 
задача: задача задач 
критический: критических 
инициировать: инициировать инициирует 
конкретно: конкретно 
сервер: сервере сервер сервером сервера серверы 
размер: размер размером 
глаз: глаз глазами 
обращение: обращения обращение 
безопасность: безопасности безопасность 
режим: режима 
опередить: опередить 
написать: написана написан написанных написано 
посетить: посетила 
прошлый: прошлой прошлые прошлых прошлая 
дыра: дыры дыре 
нагрузка: нагрузку нагрузка 
логический: логическое 
именно: именно 
устройство: устройстве устройство устройства устройством 
четыре: четырех четыре 
промокод: промокод 
код: коды кодом кода кодам код коде 
маскировка: маскировкой 
повсеместно: повсеместно 
последующий: последующим 
произвольный: произвольных 
дело: деле дело делу 
мысль: мысль 
зашифровать: зашифрован зашифрованных 
плечо: плечах 
фрагмент: фрагменты 
свой: свой свои своих свое 
известный: известной 
причина: причинам 
запуск: запуск запуска 
ввод: вводом ввода 
начинать: начинает начинают начинаем 
добавить: добавить 
метод: метода метод 
вредоносный: вредоносная вредоносный вредоносного вредоносных вредоносные вредоносному 
москва: москве 
делаться: делается 
год: лет году 
адрес: адреса адресу адрес 
естественно: естественно 
помощь: помощью 
такой: такие таким таких 
выглядеть: выглядел выглядит 
интересно: интересно 
находиться: находятся находится 
пользователь: пользователя пользователь пользователей пользователях 
иметь: имеют имеет имеющий 
открытие: открытия 
перейти: перейдем 
равно: равно 
получать: получаем получает 
вид: виде 
поговорить: поговорим 
связываться: связываться 
начальный: начальной начальный 
никто: никто 
расположить: расположен 
определённый: определенных 
отсутствовать: отсутствует отсутствуют 
другой: другими другие других 
язык: языка языком язык 
который: которые которой которая которых который которую которое котором которого 
пользовательский: пользовательского 
взаимодействовать: взаимодействуют взаимодействует взаимодействовать 
приветствовать: приветствую 
рабочий: рабочего рабочей 
дзен: дзен 
возможность: возможность возможности 
пытаться: пытаются 
несколько: нескольким несколько 
конфига: конфига 
авторизация: авторизации 
поздний: позже 
вмешаться: вмешаться 
тематически: тематически 
заниматься: занимающейся 
компьютер: компьютер 
закрыть: закрыть 
вредонос: вредоносов вредоноса вредонос 
загрузка: загрузки загрузку загрузка 
подпрограмма: подпрограмму подпрограмм 
четвёртый: четвертый 
поиск: поиск 
путь: пути путь 
тот: те та 
нло: нло 
использовать: использовать используют использован используемые используемый использует используя 
ежедневный: ежедневное 
воровать: воруя 
лишь: лишь 
существовать: существует 
обеспечивать: обеспечивающий 
карма: карма 
конструкция: конструкцией 
пароль: пароли 
показать: показав показал 
открытый: открытом открытым 
монета: монеты 
прилететь: прилетело 
простота: простота 
работа: работы работу 
управление: управления 
непривилегированный: непривилегированный 
фишинговый: фишинговые фишинговых 
цель: целью 
совершенно: совершенно 
электронный: электронный 
выполнять: выполняет выполнять выполняют 
специфика: специфику 
остаться: остаться 
анализировать: анализируем 
риска: рисках 
источник: источников 
атаковать: атаковать 
далее: далее 
обещать: обещают 
файл: файлов файле файлу файла файлы файл 
дц: дц 
недавно: недавно 
тариф: тарифы тарифа 
следующий: следующую следующие следующим следующий следующему следующее следующего 
задействовать: задействует задействуем 
скачать: скачать 
отключить: отключить 
настройка: настройка 
многофункциональный: многофункциональный 
десятка: десятки 
арсенал: арсенал 
обнаружить: обнаружить 
загрузчик: загрузчик 
два: двумя двух две 
отображать: отображает 
стать: статей 
связь: связи связь 
замечательный: замечательные 
уделить: уделено 
командный: командном командным командного 
вызов: вызова 
профиль: профиль 
хешировать: хешированные 
неисправность: неисправностей 
зависимость: зависимости 
скрытый: скрытой скрытый 
доступ: доступе доступ 
мир: миру 
сетапа: сетап 
декомпилятор: декомпилятор 
импортировать: импортируемых 
следствие: следствие 
обнаружение: обнаружение обнаружения 
относительный: относительная 
вышеупомянутый: вышеупомянутую 
базовый: базовые 
направить: направлены 
удалять: удаляет 
участок: участков участком 
основный: основными основную 
весить: весит 
раздел: раздела 
хакер: хакер 
драйвер: драйвер драйвера драйверами драйвере 
хеш: хеша 
системный: системных системного системную 
попросить: попросит 
исключать: исключаю 
понаблюдать: понаблюдаем 
б: б 
доступность: доступность 
слепок: слепок 
старый: старую 
сеть: сети 
успеть: успели 
этот: этому эта этих 
исключительно: исключительно 
сторона: сторона 
называть: называемый 
исходить: исходит исходя 
он: нему 
примерный: примерный 
её: её 
контролироваться: контролироваться 
увидеть: увидеть 
наличие: наличие 
неверный: неверным 
тело: теле 
запасный: запасной 
россия: россии 
дата: дату 
корректив: коррективы 
объяснение: объяснение 
мониторинг: мониторинг 
токен: токены 
говорить: говоря говорил 
это: это 
разный: разными разных 
упоминаться: упоминалось 
нагружать: нагружает 
вариант: варианта вариант 
выполнение: выполнение выполнения выполнении 
центральный: центральной центральный 
взаимный: взаимное 
заметить: заметить заметите заметили 
первый: первого первый 
машина: машине 
подозрительный: подозрительных 
каталог: каталога 
нерелевантный: нерелевантный 
телеграм: телеграма телеграм 
сотня: сотнями 
статический: статического 
запрос: запрос запроса запросы 
обязательный: обязательной 
новость: новости 
этап: этапе этапа этап 
получение: получения получение 
получить: получил получить полученное 
вскрывать: вскрываем 
поддержка: поддержка 
тест: тесты 
предоставлять: предоставляя 
дополнительный: дополнительной дополнительная 
делать: делаем делать 
примечательный: примечательный примечательного 
эксплуатировать: эксплуатирует 
маркетолог: маркетолог 
классика: классике 
краткий: краткому краткий 
лёгкость: легкостью 
один: одном одна одной 
передать: передать 
примечательно: примечательно 
хранить: хранить 
общий: общую 
особо: особо 
человек: людей 
множество: множество множества 
предназначить: предназначенных 
структура: структуру 
результат: результат результаты 
скорее: скорее 
повышать: повышает повышали 
обвести: обвести 
дать: данной данные 
хаба: хабы 
указать: указана 
вирусный: вирусному вирусного 
ввести: ввести 
компилятор: компилятор компилятора 
экспорт: экспорта 
надежда: надежда 
смысл: смысла 
подряд: подряд 
собранный: собранные 
образ: образом 
вопрос: вопросов 
сетевой: сетевого 
стиллер: стиллера 
замаскированный: замаскирован замаскированный 
использование: использование использованием 
ядро: ядра 
практичность: практичность 
дизассемблер: дизассемблер 
угроза: угрозе угрозу угрозой угрозах 
определить: определить 
специалист: специалистов 
кб: кб 
визуальный: визуального 
быстрый: быстрого 
подробный: подробное подробнее 
третий: третьего третий третьей 
скриншот: скриншоте 
эксклюзивный: эксклюзивное 
хороший: хороший хорошие лучшие лучшей хорошей 
список: список 
основной: основной основные 
практика: практике 
дениск: дениска 
ещё: ещё 
расшифровываться: расшифровывается 
показатель: показатели 
происходить: происходит 
собирать: собирать собираемой 
эмейл: эмейл 
открывать: открываем 
криптосфера: криптосферой 
инфраструктура: инфраструктуру инфраструктура 
хеширование: хеширование 
загружать: загружает загружаемых загружать загружая 
инжиниринг: инжиниринга 
директория: директории 
уйти: уйти 
качество: качестве 
большинство: большинстве большинством 
необходимый: необходимых 
хэш: хэш 
скачивание: скачивании скачивание 
злодей: злодеи злодей 
создавать: создает 
порадовать: порадовали 
снова: снова 
идти: идет 
становиться: становится 
относиться: относящиеся 
тег: теги 
программа: программ программы 
голова: голова 
печальный: печальное 
теория: теории 
поражающий: поражающее 
вернуться: вернемся вернуться 
анонимность: анонимность 
внутренний: внутренней 
конфигурация: конфигурация конфигурации 
прочтение: прочтение 
шаг: шага 
маскировать: маскирует 
просмотреть: просмотреть 
информационный: информационная информационный 
заражать: заражая 
заново: заново 
огромный: огромный 
заменять: заменяли 
критичный: критичным 
оно: оно 
поэтому: поэтому 
предпочитать: предпочитают 
мью: мью 
компания: компании компанией 
неприветливый: неприветливая 
извлечь: извлечь 
статья: статье статьях 
аргумент: аргументов 
вовсе: вовсе 
соединение: соединение соединения 
непосредственно: непосредственно 
прослеживать: прослеживает 
слово: словами 
мишень: мишенью 
проверка: проверки проверку проверка 
дропперо: дроппером дроппера дроппере 
требоваться: требуются 
обстоятельство: обстоятельств 
очень: очень 
обычный: обычного обычный 
жертва: жертва жертвы 
вокруг: вокруг 
утилит: утилит 
айпить: айпи 
кстати: кстати 
устанавливать: устанавливает 
процесс: процессу процесс процессов процесса 
небольшой: небольшой 
отключать: отключает 
наш: нашего нашем нашими 
кроме: кроме 
свойство: свойств 
данный: данном данного данный 
способный: способен 
итак: итак 
явно: явно 
вывод: выводы выводом вывода 
отбавлять: отбавляй 
антивирус: антивирусов антивирусы антивируса 
образец: образце 
пройти: пройти 
особый: особой особое 
пренебречь: пренебрег 
действительно: действительно 
присутствовать: присутствовал 
запустить: запущен 
архив: архив архива 
письмо: писем письмо 
следом: следом 
присущий: присущие 
чудо: чуда 
появляться: появляется появляются 
реверс: реверс 
исполняемый: исполняемый 
описать: описанной 
просто: просто 
безусловно: безусловно 
заражение: заражения 
сбережение: сбережений сбережения 
таблица: таблицу таблицы 
ситуация: ситуации 
разработчик: разработчикам 
осмотр: осмотра 
планировщик: планировщик 
серьёзный: серьезную 
сбор: сбор 
чей: чьих 
представляться: представляется 
тип: типу тип 
файлик: файлик 
затем: затем 
иметься: имеется 
начинаться: начинается 
внести: внести 
план: плану 
использоваться: используются использоваться используется 
компонент: компонент 
низкий: низкая 
прекрасный: прекрасный 
копирайтинг: копирайтинг 
закрепление: закрепление 
снимок: снимки снимках 
проводиться: проводятся 
предлагать: предлагает 
ведение: ведение 
исходящий: исходящие 
исключение: исключение 
также: также 
расшифровка: расшифровка 
сокрытие: сокрытия 
репозиторий: репозитория репозиторий 
простенько: простенько 
угол: углами 
дизассемблирование: дизассемблированием 
повторять: повторяйте 
новый: новыми новых новый новой 
работать: работают 
свидетельствовать: свидетельствует 
подверженный: подвержены 
мы: нам 
мьютекс: мьютекса 
печенька: печенек 
браузер: браузеров 
потерять: потерял 
кириллица: кириллице 
неоднократно: неоднократно 
библиотека: библиотеки библиотекой библиотек 
привилегия: привилегии привилегий 
создание: создание создания 
заполучить: заполучить 
достаточно: достаточно 
весь: всему 
вирустотать: вирустотал 
конец: концу 
приём: приемов 
практически: практически 
какой: какие 
указание: указанием 
плохиш: плохиша 
удаться: удалось 
затруднять: затрудняет затрудняющих 
оказаться: оказалось 
она: неё 
вчера: вчера 
вложение: вложениях вложения 
содержать: содержащие 
европа: европе 
ранее: ранее 
лёгкий: легче 
палец: пальца 
аналогично: аналогично 
клавиатура: клавиатуре 
бот: бот бота 
информация: информацию информации информация 
сайт: сайт 
примитив: примитив 
содержаться: содержащихся 
стадия: стадии 
отметить: отметить 
удивление: удивлению 
процессор: процессор 
мина: мин 
реагирование: реагирования 
состоять: состоит 
построить: построен 
веб: веб 
мол: мол 
уязвимый: уязвимому 
неизвестный: неизвестным 
дроппер: дроппер 
операция: операций 
импорт: импорта 
заветный: заветного 
давать: давайте дает 
золотой: золотые 
дропперный: дропперная 
захотеться: захотелось 
сутки: сутки 
крайне: крайне 
справиться: справилась 
самый: самая самое 
кой: коем 
антивирусный: антивирусных 
идентификатор: идентификатор 
ссылаться: ссылается 
выделить: выделенные 
связать: связаны 
применение: применений 
отправлять: отправляет 
иначе: иначе 
текстовый: текстовый 
момент: моменте момент 
нужный: нужен 
изменение: изменения 
заблуждение: заблуждение 
цельный: цельной 
банально: банально 
затронуть: затронем 
несанкционированный: несанкционированной 
цифровой: цифровой 
стартовать: стартует 
знак: знаком 
выше: выше 
быть: будем будут 
опасный: опасных 
прописать: прописано 
переход: переходе 
содержимое: содержимое 
запутать: запутать 
утихать: утихает 
помогать: помогает 
назначение: назначением 
вкус: вкусом 
пойти: пошло 
данные: данных 
рассматривать: рассматривать 
компиляция: компиляции 
случай: случаев случае 
опасность: опасности 
немного: немного 
рейтинг: рейтинг 
любой: любые любой 
составлять: составляет 
вконтакте: вконтакте 
исследовать: исследуемые 
сложно: сложно 
технический: техническая технический 
тень: тени 
журнал: журнала 
полностью: полностью 
дебаггера: дебаггер 
уловить: уловить 
остановить: остановить 
самостоятельно: самостоятельно 
окончательный: окончательную 
количество: количество 
соответствовать: соответствующей 
отдельный: отдельных 
найти: найти 
поехать: поехали 
усложнить: усложнить 
семейство: семейство 
таргетировать: таргетированный 
наблюдать: наблюдаем 
инструмент: инструмент 
отличаться: отличается 
закладка: закладки 
безвозвратно: безвозвратно 
форма: форма 
ничто: ничем 
похожий: похожие 
оставить: оставило 
блог: блога блог 
модифицированный: модифицированной 
возможный: возможных 
мотив: мотивы 
вестись: ведитесь 
подробно: подробно 
фаза: фазы 
себя: собой 
фигурировать: фигурировали 
хабра: хабр 
рассказывать: рассказывал 
красть: крадет 
престижный: престижную 
сразу: сразу 
заголовок: заголовков 
произвести: произвести 
антикриминалистический: антикриминалистический 
имя: имя 
потенциально: потенциально 
кошелёк: кошельков 
распространяться: распространяться распространялось распространяется 
позволить: позволит 
алгоритм: алгоритм 
обновить: обновить 
связанный: связанный 
передумать: передумает 
писать: писал 
посредством: посредством 
проверить: проверить 
неумело: неумело 
время: время 
журналист: журналистом 
прогрев: прогрев 
открыть: открыть 
никак: никак 
вносить: вносит 
максимум: максимум 
эффективность: эффективность 
экран: экрана 
стоить: стоит 
публикация: публикации 
исчисляться: исчисляются 
кибербезопасность: кибербезопасностью 
скачивать: скачивает скачивайте 
успешный: успешном 
узнать: узнать 
набор: набор 
мурхеш: мурхеша 
криптодержатель: криптодержателей 
х: х 
гора: горы 
сообщение: сообщения 
описание: описание 
преимущество: преимущество 
единственный: единственной 
цепочка: цепочку 
понимать: понимает 
защитник: защитника защитник 
главный: главным 
синхронизация: синхронизации 
нажатие: нажатий 
текс: текс 
строка: строк 
порой: порой 
финальный: финальной 
основное: основном 
секретный: секретные 
маячить: маячить 
утилита: утилита 
стыковаться: стыкуется 
уникальный: уникальное 
каждый: каждая 
вторичный: вторичный 
быстро: быстро 
дабы: дабы 
очевидный: очевидно 
диагностик: диагностику 
существенный: существенен 
разметить: разметим 
разобрать: разберем 
исчезнуть: исчезла 
создатель: создатели 
установка: установки 
характер: характер 
особенность: особенности 
поместить: помещены 
производиться: производится 
фраза: фразы 
экземпляр: экземпляром 
удаление: удаление 
