мочь: могут мог 
маленький: маленькое 
путешественник: путешественник 
удивительно: удивительно 
различный: различных 
свой: своего своему 
несложно: несложно 
тёмный: тёмные 
оставить: оставить 
прочий: прочие 
являться: является 
клетка: клетки клетка клеток клетками 
любой: любого любом 
единственный: единственное 
правило: правилах правила правилам правил правило правиле 
натюрморт: натюрмортов 
поле: поле 
окрестность: окрестность окрестности 
соседствовать: соседствующих 
определённый: определённом определённым определённых 
яндекс: яндекс 
вариант: варианте варианта варианты вариант 
эквивалентный: эквивалентны 
дизайн: дизайн 
зажигаться: зажигается 
перемещаться: перемещаются 
тьюринг: тьюринга 
крупный: крупнейшем 
минус: минусом 
вариация: вариациями вариации 
состояние: состояний состоянии 
соответственно: соответственно 
смотреть: смотрим 
фон: фон 
реализовать: реализованы 
израиль: израиля 
фитиль: фитилей фитиль фитили 
второе: второе 
убирать: убирает 
представление: представления представлению 
сегрегация: сегрегация 
один: одну одним одно 
бонус: бонус 
комментарий: комментарии 
голос: голосов 
хаотично: хаотично 
взрыв: взрывы взрыва 
анимация: анимации 
соседний: соседние 
светлый: светлые 
относиться: относятся 
тема: темы 
меню: меню 
помимо: помимо 
удобный: удобнее 
планер: планерам 
сложный: сложный 
интересный: интересных 
рунет: рунете 
нигде: нигде 
взрывной: взрывные взрывное 
осциллятор: осцилляторы 
часть: часть 
перейти: перейдём 
другой: другим другими другие других 
инвертировать: инвертированный 
самый: самыми 
расположение: расположениям расположения расположение расположений 
живой: живы живых жива живыми живые 
поведение: поведение 
часто: часто 
переходить: переходит 
дело: деле 
удивительный: удивительных 
классический: классических 
перетекать: перетекающими 
мерцание: мерцание 
нетоталистичный: нетоталистичной нетоталистичные 
стык: стыка 
добавить: добавить 
число: чисел 
однако: однако 
хенсель: хенселем хенсель хенселя 
сам: самом 
сто: сто 
корабль: кораблей кораблём корабль кораблями корабля 
жизнь: жизнь 
автомат: автомате автоматов автоматы автомат 
кодировать: кодировать 
равно: равно 
остров: островами острову 
мёртвый: мёртвые мёртвыми мертва 
язык: языка язык 
который: которые которая которых которому 
шаг: шаг 
дзен: дзен 
возможность: возможность 
друг: другом друг 
порождать: порождающее порождающих порождает порождая 
начальный: начальном 
итог: итоге 
паттерн: паттерна паттернов паттерны паттернами 
поздний: позже 
видимый: видимые 
этнический: этнических 
дизайнер: дизайнер 
расширяться: расширяющиеся 
комбинация: комбинаций комбинации 
сводиться: сводятся 
термин: термин 
повреждение: повреждении повреждений повреждение 
буква: буквы букв 
поиск: поиск поиска 
одномерный: одномерную 
лишь: лишь 
реализация: реализации 
оставлять: оставляя 
ищущий: ищущий 
карма: карма 
соединить: соединены 
обозначить: обозначенной 
распределение: распределение 
стандарт: стандартом 
сугубо: сугубо 
базовый: базовую базовой 
смежный: смежных 
родитель: родителей 
популярный: популярное популярнейшая 
сегодня: сегодня 
стартовый: стартовых стартов 
настройка: настройка 
обозначение: обозначения обозначении 
генератор: генераторов генератор генераторах 
научно: научно 
возникать: возникает 
коллекционер: коллекционером коллекционеров 
неизотропный: неизотропные 
сосед: соседей 
профиль: профиль 
мур: мура 
разрушиться: разрушиться 
зависимость: зависимости 
заполнять: заполняем 
космический: космический космическим космического космических космическими 
лесной: лесных 
моделирование: моделирование моделирования 
далеко: далеко 
город: городах 
внутренний: внутренний 
начало: начала 
разматываться: разматывающиеся 
взрывопликатор: взрывопликатор 
вводный: вводная 
старый: старую 
репликатор: репликаторы 
клеточный: клеточные клеточный клеточных клеточном 
этот: этому 
предваряться: предваряется 
алгоритм: алгоритмы 
скорость: скоростью 
вихреподобный: вихреподобные 
учитывать: учитывает 
её: её 
изотропный: изотропные 
сторона: стороны сторон 
г: г 
род: рода 
алан: алан аланом 
многий: многих 
демонстрация: демонстрации 
посчитать: посчитать 
это: это 
учёт: учёта 
данный: данное данном данный 
коллекционирование: коллекционирование 
танковый: танковое 
существовать: существуют 
поддержка: поддержка 
обзор: обзор 
деталь: детали 
быть: е будем будут 
поток: потока 
весьма: весьма 
результат: результат 
эволюционный: эволюционные 
хаба: хабы 
модель: модель 
несмотря: несмотря 
редкий: редкое 
кириллический: кириллического 
возможный: возможной возможным 
регулярно: регулярно 
следующий: следующие следующем 
грань: граням 
подобный: подобных 
забор: заборов забора 
расширить: расширили расширим 
выглядеть: выглядит 
вне: вне 
цикличный: цикличном 
ещё: ещё 
оптимизатор: оптимизатор 
выживание: выживание 
пугаться: пугайтесь 
происходить: происходит 
обобщать: обобщает 
первый: первое 
последний: последнюю 
конкретный: конкретных конкретное конкретного 
взрывать: взрывает 
взглянуть: взглянуть 
такой: такое таких 
слишком: слишком 
нотация: нотацией нотации нотация нотацию 
механика: механика 
соответствующий: соответствующими соответствующих 
составить: составленных 
обычно: обычно 
тег: теги 
каждый: каждым 
сделать: сделаем 
заменять: заменяет 
диагональный: диагональный диагонально 
слиться: слиться 
теория: теории теория 
ниже: ниже 
защитить: защищены 
уровень: уровень 
конфигурация: конфигурация конфигурацию конфигураций конфигурации 
прочтение: прочтение 
генерировать: генерирует 
огромный: огромное огромному 
например: например 
встречаться: встречаются 
читать: читайте 
благодаря: благодаря 
длинный: длинным 
стремиться: стремятся 
получить: получившая 
изменение: изменений изменение 
бинарный: бинарному 
история: история истории 
максимально: максимально 
разрушение: разрушения разрушении 
голова: голову 
интернет: интернет 
вернуться: вернёмся вернувшись вернуться 
ровно: ровно 
зубчатый: зубчатых зубчатой 
фотон: фотоны фотонам фотонов 
анизотропный: анизотропные 
очень: очень 
ка: ка 
включать: включает 
ружьё: ружей 
цикл: цикл 
небольшой: небольшой 
счёт: счёта 
кроме: кроме 
автор: автора 
сопоставлять: сопоставлять 
знакомиться: знакомиться 
таблица: таблицам таблицы 
позиция: позиции 
построить: построенная 
рождение: рождения рождение 
светов: световым 
среда: среде 
слияние: слияния 
машина: машину машина 
нейман: неймана 
устройство: устройства 
просто: просто 
предложить: предложена 
близкий: близкий 
два: двум двух две 
битовый: битового 
всё: всё 
зрелищный: зрелищных 
версия: версию 
простой: простейших простой 
ваш: ваши 
причём: причем 
зависеть: зависящие 
известный: известных 
остаться: оставшаяся 
также: также 
де: де 
идейно: идейно 
наш: нашем 
разный: разный 
устояться: устоявшегося 
менять: менять 
увидеть: увидим 
влиять: влиять 
катушка: катушку катушки 
общество: общества 
игра: игра 
сокращать: сокращаемые 
объект: объект объектом объектами 
стать: стала 
обработка: обработке 
практически: практически 
шеллинга: шеллинга 
изначальный: изначальном 
удаться: удалось 
схожий: схожа схожее 
хороший: лучшие 
соответствовать: соответствуют 
вчера: вчера 
ранее: ранее 
сигнальный: сигнальные 
поглотить: поглотить 
логический: логических 
отходить: отходя 
орнамент: орнамент 
танк: танк 
ступенчатый: ступенчатым 
представить: представлено 
отросток: отросток 
значение: значениями 
удивление: удивлению 
мина: мин 
веб: веб 
он: нём 
операция: операций 
необычный: необычные 
лёгкий: лёгкое 
вид: вида видов вид 
сутки: сутки 
соседство: соседства 
меняться: меняется 
настигать: настигая настигает 
три: трёх 
группа: групп группа 
новый: новых 
совмещение: совмещении 
весь: всем 
столкновение: столкновением 
иначе: иначе 
паровоз: паровозы 
пожар: пожаров 
стандартный: стандартную 
хеш: хеш 
повредить: повреждены 
вакансия: вакансии вакансий 
итерация: итерацию 
создаваться: создаются 
причудливый: причудливыми 
столкнуться: столкнувшийся 
поколение: поколениями поколении 
категория: категория 
пример: примере примера 
рассматривать: рассматривать рассматриваем 
начать: начнём 
повреждаться: повреждается 
вроде: вроде 
предел: пределами 
рейтинг: рейтинг 
взаимодействие: взаимодействием 
отметить: отметим 
простейшее: простейшими 
направление: направления направление 
технический: техническая 
записываться: записывается 
фамилия: фамилии 
количество: количество 
цвет: цвета 
пока: пока 
называться: называется 
впоследствии: впоследствии 
найти: найти 
либо: либо 
довольно: довольно 
закладка: закладки 
цифра: цифры 
лавина: лавиной 
программирование: программирование 
продолжить: продолжим 
выражаться: выражается 
похожий: похожие 
многие: многие 
двойной: двойной 
рассмотреть: рассмотрели 
себя: собой 
хабра: хабр 
зал: зал 
работа: работа 
сложность: сложности 
момент: момент 
аббревиатура: аббревиатуры 
имя: имя 
факто: факто 
обновить: обновить 
читальный: читальный 
время: время 
ортогональный: ортогонально 
иной: иного 
фигура: фигур фигуры 
немало: немало 
схема: схемы 
заранее: заранее 
отличаться: отличающиеся 
шаблон: шаблонам 
просмотр: просмотров 
публикация: публикации 
линейный: линейный 
так: т 
набор: набор 
пятничный: пятничные 
односторонний: одностороннем 
хвост: хвоста 
старт: стартом 
открыто: открыто 
случайный: случайного 
ромбовидный: ромбовидные 
эргономист: эргономист 
расширять: расширяет 
предлагать: предлагайте 
собрать: собрать 
поймать: поймать 
неизвестный: неизвестный 
случай: случае 
отдельный: отдельная 
ромбовый: ромбов 
каталог: каталоге 
энтузиаст: энтузиастов энтузиастом 
заготовить: заготовленных 
целый: целых 
армада: армады 
описать: описана 
обсуждать: обсуждаемой 
вхождение: вхождения 
