весь: весь 
контрагент: контрагенты контрагентам контрагентов контрагента 
адрес: адресов 
мочь: могут можем могу могла 
справочник: справочников справочника справочник справочником 
задача: задачи задача задачу 
конкретный: конкретную конкретной конкретном 
обычный: обычными 
приложение: приложения 
простой: простых простой 
накладный: накладные 
эффективный: эффективны 
свой: своего свой свои своих свое своими 
прочее: прочее 
покодировать: покодировать 
расширить: расширенные 
перевод: перевода 
любой: любого любому любой 
платформа: платформы платформу 
статус: статусом 
одинаковый: одинаковые 
типовой: типовым типовых типовая типовые типовой 
поле: поле 
враг: враг 
решение: решениям решениях решение решения 
подразумевать: подразумевает 
контрагентыколь: контрагентыколи 
крупный: крупный 
жёсткий: жесткая жестких 
префикс: префиксом 
яндекс: яндекс 
обработка: обработки обработку 
видный: видны 
поскольку: поскольку 
получиться: получится 
хороший: лучшего лучший хороший лучшие лучшее 
метод: методы метода методами методе методов 
значение: значение значения 
архитектор: архитектору 
возможно: возможно 
успешно: успешно 
будущее: будущем 
наверняка: наверняка 
разработка: разработкой разработке разработка разработку 
документ: документ документы 
прикладной: прикладная прикладных 
ооо: ооо 
реализовать: реализованы 
ваш: вашей вашему ваша 
платёжный: платежных платежное платежные платежному платежного 
коли: коли 
подходить: подходит подходят 
хозрасчётный: хозрасчетный 
система: система системах систему 
сказать: скажет 
игнорировать: игнорировать 
комментарий: комментарии комментариях 
автоматизировать: автоматизировать 
международный: международной 
класс: класс классами классы класса классом классу 
разрабатывать: разрабатывать 
разработчик: разработчики разработчик разработчика 
бухгалтерский: бухгалтерский 
оптимальный: оптимальным оптимальной 
микросервис: микросервисы микросервисов микросервиса 
очередной: очередной 
голос: голосов 
реквизит: реквизитов реквизита реквизиты реквизитами 
тема: темы тема 
меню: меню 
выражаться: выражаться 
различный: различные различная 
доступный: доступный доступна 
бухгалтерия: бухгалтерии бухгалтерию бухгалтерия 
сделать: сделает сделать сделаем сделан 
взять: возьмем 
обсуждаться: обсуждалось 
далее: д далее 
ориентировать: ориентированы 
исполнение: исполнении 
синергия: синергии 
программист: программист 
журнал: журнал 
библиотека: библиотеку библиотеки библиотека библиотеками библиотекам 
обёртка: обертками обертки 
распространение: распространения 
база: базе 
механизм: механизмы механизма 
увеличить: увеличить 
возвращаться: возвращаемся 
именно: именно 
часто: часто 
соотношение: соотношение 
оговорить: оговоренным 
речь: речь речи 
производительность: производительностью производительности производительность 
книга: книги 
реализация: реализаций реализации реализацию 
решать: решаемы решать 
добавить: добавить 
вакансия: вакансия вакансии вакансий 
захотеть: захочет 
зависеть: зависит 
развиться: развиться 
помощь: помощью 
такой: такие такое такого таком таким такая 
видно: видно 
являться: являются 
нужно: нужно 
кпп: кпп 
аннотация: аннотацию аннотациях аннотации аннотациями аннотация аннотаций 
находиться: находятся 
случай: случаях случае 
иметь: имеют имеет иметь 
определиться: определится 
инна: инн 
вид: виде вида 
получать: получаем 
пустой: пустом 
язык: языка языках языком язык 
этот: этими эта 
получаться: получается 
который: которые которая которых который которое 
аннотировать: аннотировать 
требовать: требует 
зазеркалье: зазеркалье 
обмен: обменами 
тажа: таже 
англоязычный: англоязычного 
дзен: дзен 
поверьте: поверьте 
возможность: возможность возможностями 
мэппинг: мэппингов мэппинга мэппинг 
независимый: независимых независимой независимая 
василиса: василисы василису василиса василисе 
итог: итоге 
самостоятельный: самостоятельные 
модель: моделями 
относительно: относительно 
поручение: поручение поручению поручения поручений 
определение: определение 
практика: практика практику 
проводок: проводки 
поиск: поиск поиска 
путь: пути 
например: напр например 
специфика: специфики 
хотяб: хотябы 
использовать: использовать использующий использует используя 
смотреть: см смотреть 
предприниматель: предпринимателями 
покой: покоя 
карма: карма 
дата: дата 
тип: типа типы типов 
страница: странице 
счёт: счетов счета 
клиент: клиентами 
быть: будете е будем будут 
цитата: цитату 
трудность: трудности 
отчёт: отчет отчеты 
совместимый: совместимо совместимые совместимых 
несколько: несколько нескольких 
место: месте места место 
называть: называть 
соответствие: соответствия 
проблема: проблема проблем проблемы 
нравиться: нравится 
преобразование: преобразованиями преобразованиям 
настройка: настройка 
гарантировать: гарантированный 
сожаление: сожалению 
управленческий: управленческого управленческий 
возможный: возможна 
возникать: возникает возникают 
серия: серии 
избежать: избежать 
связь: связи связь 
профиль: профиль 
типизировать: типизированном 
зависимость: зависимости зависимостей 
хотеть: хочет хотите 
перекладка: перекладку перекладок 
следовать: следуя 
унаследовать: унаследовать 
нерезидент: нерезидентов нерезидента 
набор: наборов 
следствие: следствие следствия 
нужный: нужное нужные нужен нужный 
решаться: решается 
неявный: неявные 
план: плана планом план 
самый: самый самая самое 
нестандартный: нестандартный 
играть: играет 
понятный: понятнее 
достигнуть: достигла достичь 
ведомость: ведомости 
ссылка: ссылки ссылками ссылка 
код: кода код коде 
старый: старую 
подобный: подобные подобных подобным подобную 
фиас: фиас 
недостаток: недостатки 
невозможно: невозможно 
алгоритм: алгоритмы 
свойство: свойства свойств 
дополнительный: дополнительными 
уровень: уровня 
ооп: ооп 
подсистема: подсистем подсистема подсистемами 
таблица: таблицах таблицами 
думать: думаю думаете 
писать: пишут писать 
операционный: операционный 
это: это 
корп: корп 
совершенствовать: совершенствовать 
наименование: наименования наименованиях 
работа: работу работа работе 
наш: нашу нашем 
поставляться: поставляется 
привязаться: привязался 
поддержка: поддержка поддержкой 
сеттер: сеттеры 
банковский: банковские 
тот: та 
угодный: угодно 
функционал: функционал 
один: одном одна одному 
визуально: визуально 
правый: правы 
иц: иц 
маштабирование: маштабированию 
почему: почему 
физлицо: физлицами 
индивидуальный: индивидуальными 
результат: результат 
структура: структуру 
неявно: неявно 
почитать: почитать 
заинтересованный: заинтересованным 
независимо: независимо 
позволять: позволяет позволяют 
подписываться: подписывайтесь 
хаба: хабы 
способ: способ способом 
должный: должен 
рамка: рамках 
перестать: перестанет 
приходиться: приходилось приходится 
сущность: сущности сущностей 
стандартный: стандартных стандартные 
определять: определяем 
внедрить: внедренные 
следующий: следующие 
создавать: создавать создает создаем 
магия: магия 
образ: образом 
сгенерировать: сгенерировать 
использование: использование 
стандарт: стандартах стандарта стандартам стандарт стандартов стандарты 
усилие: усилий усилиями 
желать: желающие 
визуальный: визуального 
обратно: обратно 
торт: торте 
заполнить: заполнен 
свободный: свободным 
пользователь: пользователь 
рбп: рбп 
аналог: аналог 
полноценный: полноценной 
совместимость: совместимости 
очевидный: очевидные очевидно 
связанность: связанности 
использоваться: использовался использоваться используется 
современный: современных 
платёж: платежам 
собирать: собирать 
форма: формы форму 
связать: связанная 
встречаться: встречаться 
проект: проект 
аналогичный: аналогичное 
подход: подходе подходом 
прогресс: прогресса 
ведение: ведения ведение 
горизонтальный: горизонтальному 
устанавливать: устанавливать устанавливает 
учёт: учета учете учет учетом 
сумма: сумма 
ожидание: ожидания 
избыточный: избыточна 
идти: идет 
отдельный: отдельной отдельными отдельных 
тег: теги 
дизайн: дизайну 
уведомлять: уведомляя 
теория: теории 
продукт: продукт 
проникнутый: проникнут 
идентификактор: идентификакторе 
конфигурация: конфигурация конфигураций конфигурациях конфигурации 
прочтение: прочтение 
госорган: госорганами 
огромный: огромное 
сальдовый: сальдовые 
прежде: прежде 
василий: василия 
оно: оно 
миф: миф 
поэтому: поэтому 
разный: разные разных 
история: история истории 
делать: делать 
легко: легко 
направление: направлении 
соединение: соединение 
вопрос: вопросы вопрос 
мнение: мнение 
дорабатывать: дорабатывать 
разрез: разрезе 
смысл: смыслу 
контактный: контактная 
нежели: нежели 
любитель: любители 
метаданные: метаданных метаданными 
очень: очень 
популярный: популярный популярная 
получить: получим 
каждый: каждого каждый 
термин: терминах 
кроме: кроме 
данный: данном 
отличие: отличии 
бывать: бывает бывают 
преследовать: преследует 
итак: итак 
концепция: концепция концепции 
польза: пользу 
оформить: оформят 
спонсирование: спонсировании 
оборотный: оборотно 
справляться: справляться 
рф: рф 
слияние: слияния 
создать: создать 
решить: решить решишь 
круг: круг 
кошмар: кошмара кошмар 
написать: написан написаны напишем написано 
представить: представлены 
инфостарт: инфостарт 
просто: просто 
генерироваться: генерируется 
универсальный: универсальном 
полный: полном 
захотеться: захочется 
успех: успехов 
встретиться: встретятся 
форум: форум 
важно: важно 
обрабатываться: обрабатываются 
версия: версию версии 
кто: кому 
чтение: чтения 
сравнение: сравнению 
оторваться: оторваться 
применяться: применяется 
компонент: компонент 
мечта: мечта 
прикручивать: прикручивать 
соответствовать: соответствовать соответствует 
постащиками: постащиками 
помочь: поможет 
партнёрский: партнерских 
чётко: четко 
регион: региона 
постоянный: постоянного постоянная 
выдержать: выдержит 
иной: иным 
распространить: распространенная 
стать: стало 
также: также 
цель: цели 
набросать: набросает 
идеал: идеале 
положение: положении 
менее: менее 
примениться: применятся 
стиль: стиле 
повторный: повторное 
попытка: попытках 
сократить: сократить 
проявляться: проявляются 
отсылка: отсылок 
плюс: плюс 
мы: нам 
независимость: независимости 
хотеться: хочется хотелось 
отражать: отражает 
единый: единые 
ос: ос 
прийтись: придется 
основный: основную 
реально: реально 
монолитный: монолитного 
определимый: определим 
писаться: пишутся 
обновлять: обновлять 
создание: создание создания 
достаточно: достаточно 
практический: практическую 
спасти: спасут 
анализ: анализ 
работать: работаем работать 
содержать: содержать 
отладочный: отладочную 
слабый: слабой слабое 
пусть: пусть 
формирование: формирования 
ранее: ранее 
собственный: собственные собственный 
перекодирование: перекодированием 
пытаться: пытаемся 
вишенка: вишенка 
классификатор: классификатор 
реальный: реальной 
невыгодный: невыгодном 
организация: организации 
мой: мою 
строго: строго 
оба: оба 
ненужный: ненужное 
мина: мин 
сменить: сменить 
совместный: совместной 
статья: статьи 
жизнь: жизни 
финансовый: финансовый финансового 
суть: сути 
сутки: сутки 
привязать: привязано 
консультант: консультант 
минимальный: минимальными минимальный 
специальный: специального 
давать: дает 
брать: брать 
выявить: выявит 
ссылаться: ссылаются ссылаться 
уид: уид 
интерфейс: интерфейса 
иначе: иначе 
повториться: повторятся 
технология: технологии 
увидеть: увидите 
появление: появление 
канал: канале 
разработать: разработать 
больший: большей 
запись: записи записей 
выше: выше 
переход: переходе 
геттер: геттеры 
подсказать: подскажут 
правило: правило 
типичный: типичная 
данные: данных 
добавление: добавление 
боль: боль 
сам: сама 
туда: туда 
пример: примере пример 
материал: материалы 
рейтинг: рейтинг 
расти: растет 
проводка: проводок 
получатель: получателя получатель 
другой: другие других другую 
передавать: передавать 
огрн: огрн 
технический: техническая 
предполагаться: предполагается 
тянуть: тянуть 
полностью: полностью 
рынок: рынок 
количество: количество 
главный: главные 
пока: пока 
роль: роли 
дть: демо 
наесться: наелся 
проверка: проверка 
либо: либо 
процедура: процедуры 
программа: программа программы 
закладка: закладки 
нарушение: нарушений 
программирование: программирование 
ошибка: ошибок 
бсп: бсп 
подключить: подключить 
выложить: выложить 
похожий: похожие 
внедрение: внедрение 
вернуться: вернуться 
реальность: реальность 
петя: пети 
двойной: двойной 
поклонник: поклонников 
ощущение: ощущение 
себя: собой 
нма: нма 
хабра: хабр 
неоперационный: неоперационный 
таки: таки 
сразу: сразу 
софт: софта 
главное: главное 
объект: объекта 
парсер: парсер 
договор: договоров 
явный: явные 
позволить: позволит 
западный: западные западных 
требование: требования 
обновить: обновить 
необходимость: необходимость 
двигатель: двигатель 
чашечка: чашечкой 
время: время 
дать: данные 
разобрать: разобранным 
признак: признак 
аналитик: аналитик 
велосипед: велосипеда велосипед 
элемент: элементу 
твориться: творится 
просмотр: просмотров 
публикация: публикации 
мсфо: мсфо 
устрица: устриц 
договориться: договорится 
так: т 
определить: определили 
компания: компаний 
цена: цена 
формат: формат 
производитель: производителем 
информация: информация 
вася: васи вася васе 
ключ: ключе 
предприятие: предприятие предприятии 
преимущество: преимущество 
сложный: сложнее 
печатный: печатные 
вестись: ведется 
вставка: вставками 
они: ними 
типизация: типизация 
гладко: гладко 
обязательно: обязательно 
изобретать: изобретать 
предоставление: предоставления 
блок: блок 
телефон: телефон 
представлять: представляющего 
ограничение: ограничения ограничений 
собранный: собранный 
собрать: собрать 
готовность: готовность 
конкурент: конкуренты 
эмуляция: эмуляции 
кофе: кофе 
делиться: делится 
интересовать: интересует 
мара: мар 
год: годами 
субд: субд 
установка: установки 
бухгалтеский: бухгалтеского 
фича: фичи 
описание: описанию 
