материал: материалов 
управление: управление управления 
вклад: вкладе 
ориентация: ориентацию 
изменять: изменять 
игра: игры игр 
угол: углу 
прежний: прежнему 
приложение: приложения приложений 
вкладка: вкладки вкладке 
создать: создана создан 
настройка: настроек настройка настройки 
вверх: вверх 
игровой: игровые 
стандартный: стандартного 
яндекс: яндекс 
рисунок: рисунке 
выбирать: выбирать 
отображаться: отображаются отображается 
возможно: возможно 
соответственно: соответственно 
документ: документ 
выбираться: выбираются 
клавиша: клавиш 
иерархия: иерархии 
добавление: добавления добавление 
персонаж: персонажи 
перемещение: перемещение перемещением перемещению перемещении перемещения 
комментарий: комментарии 
голос: голосов 
размер: размеру размеры 
разработчик: разработчики разработчик разработчиков разработчиками разработчика 
куб: куб 
камера: камеру камеры камерой 
меню: меню 
сворачивание: сворачивание 
перемещаться: перемещалась 
часть: часть 
виртуальный: виртуальный 
стрелка: стрелками стрелки стрелка стрелок 
четыре: четырех 
часто: часто 
переносить: переносимый 
добавить: добавить добавленный добавлено 
находиться: находящегося 
дочерний: дочерним дочерние 
знание: знания 
перемещать: перемещать перемещает перемещают 
такой: такие 
пользователь: пользователя пользователем пользователь 
песочница: песочницы 
смена: смены 
периодически: периодически 
окно: окна окон окно окне 
расположить: расположен расположенные 
подход: подход 
язык: языка язык 
который: которые которая который которое 
требовать: требует 
поместить: помещена 
дзен: дзен 
возможность: возможность 
одновременный: одновременным 
группа: группы 
относительно: относительно 
общий: общие 
поиск: поиск 
существовать: существует 
карма: карма 
работа: работы работа 
стоящий: стоящего 
несколько: несколько 
группировка: группировка 
разворачивание: разворачивание 
файл: файлов файле файла файлы 
отобразиться: отобразилась 
необходимо: необходимо 
пкм: пкм 
профиль: профиль 
перенос: переносом 
быть: буду 
панель: панелям панель панели 
связывание: связывания 
мыший: мышью 
прикреплять: прикреплять 
ссылка: ссылки 
старый: старую 
копировать: копировать 
объединять: объединять 
свойство: свойства свойств 
сфера: сфера 
графический: графического графическая 
программный: программная программный 
умение: умения 
иметь: имеет 
расположение: расположения расположение 
редактор: редактор редактора редактором 
поддержка: поддержка 
сохранение: сохранение 
функционал: функционал 
пространство: пространстве 
дать: данной 
позволять: позволяет 
объект: объектов объект объекты объекта 
хаба: хабы 
создавать: создавать создаваемый 
образ: образом 
туториал: туториал 
зажатие: зажатием зажатии 
проект: проект проекте 
положение: положение 
проводник: проводника 
аналогичный: аналогичное аналогичным 
обновляться: обновляются 
перенести: перенести 
сцена: сцена сцене сцену 
становиться: становится 
тег: теги 
вниз: вниз 
уровень: уровень 
прочтение: прочтение 
статья: статье статья 
редактирование: редактирование 
вперёд: вперед 
сортировать: сортировать 
эффект: эффекты 
область: область 
лкм: лкм 
группировать: группировать 
развернуть: развернуть 
удалять: удалять 
верхний: верхнем верхней 
диалоговый: диалоговое диалоговом 
рис: рис 
применение: применением 
свет: свет 
выбрать: выбран выбрать выбранного 
вращение: вращение вращении 
загрузка: загрузка 
просматривать: просматривать 
назад: назад 
выполняться: выполняется 
версия: версию версия 
применяться: применяется 
использоваться: используются используется 
доступный: доступных 
пользоваться: пользоваться 
черта: черты 
поворот: поворот 
вправо: вправо 
направление: направлениях 
наиболее: наиболее 
переименовывать: переименовывать 
история: истории 
перетаскивание: перетаскиванием 
тип: тип 
декорация: декорации 
комментировать: комментировать 
параметр: параметры параметров 
создание: создание создания 
точка: точки точке 
редактировать: редактировать 
урок: уроки 
содержать: содержать 
хороший: лучшие 
вчера: вчера 
ранее: ранее 
гибкий: гибкой 
они: ими 
разработка: разработке разработка 
инструмент: инструментов инструмент 
описать: описаны 
опытный: опытные 
нажать: нажать 
мина: мин 
открытие: открытие 
предисловие: предисловие 
сутки: сутки 
влево: влево 
вид: вида 
увеличиваться: увеличивается 
отображение: отображения 
выпадать: выпадающего 
добавляться: добавляются 
интерфейс: интерфейса 
текстовый: текстовый 
мир: мир 
вакансия: вакансии вакансий 
выше: выше 
открыться: откроется открывшемся 
содержимое: содержимое 
пустой: пустое 
список: списка 
куба: куба 
метод: методов 
рейтинг: рейтинг 
новый: новое 
другой: другие 
технический: техническая 
папка: папки 
количество: количество 
клавиатура: клавиатурой 
пункт: пункт 
навигация: навигация 
найти: найдут 
простой: простой 
закладка: закладки 
открывать: открывать 
похожий: похожие 
вернуться: вернуться 
наследовать: наследуют 
хабра: хабр 
сложность: сложности 
обновить: обновить 
ориентировать: ориентирована 
сохранить: сохранить 
возвращаться: возвращается 
основа: основы 
время: время 
открыть: открыть 
мышь: мыши 
просмотр: просмотров 
публикация: публикации 
сохраняться: сохраняются 
информация: информация 
пример: примера 
загрузить: загрузить 
право: правом 
масштабирование: масштабировании 
скорость: скорость 
начинающий: начинающих 
помощь: помощи 
масштаб: масштаб 
изменить: изменены 
вместе: вместе 
компонент: компонентов 
удаление: удаление 
приближение: приближение 
