модифицированный: модифицированного модифицированный 
весь: весь 
система: системе система системы систему систем 
мочь: могут можем 
вероятность: вероятностью вероятности вероятность 
полгода: полугода 
тестировать: тестируемая тестируют тестируемой тестировать 
первопричина: первопричиной 
тестовый: тестового тестовом тестовое 
версия: версий версиями версию версия 
оттенок: оттенок оттенки 
оказывать: оказывали 
программный: программном программного программные 
конкретный: конкретную конкретных конкретной конкретные конкретного 
оранжевый: оранжевым оранжевые 
различный: различных различные 
позволить: позволило 
выявить: выявим выявил выявить выявило 
целесообразный: целесообразными 
цвет: цветом цвет цвета 
отложить: отложили 
большой: большой большого большое большому 
категория: категориях 
потребоваться: потребоваться 
область: области областях 
зачастую: зачастую 
тикета: тикет 
направлять: направляли 
мнение: мнениях мнение мнения 
канбан: канбану 
долгий: долгое дольше 
работать: работали работающих работают работаем работала 
привести: приведенном 
применяма: применямой 
давно: давно 
новый: новым новом нового новыми ново новые новых новый 
разработка: разработки 
выполнение: выполнением выполнение выполнения 
яндекс: яндекс 
исследование: исследованиях исследований исследования 
ошибка: ошибку ошибки ошибкам ошибок 
коллега: коллег 
поскольку: поскольку 
применимый: применим 
укорачивать: укорачивает 
автоматически: автоматически 
дорогостоящий: дорогостоящих дорогостоящей дорогостоящему дорогостоящий 
рассказать: рассказать 
медленно: медленно 
напрямую: напрямую 
основываться: основываясь 
общий: общей общих 
программно: программно 
полный: полной 
увеличение: увеличению увеличение 
значение: значения 
функция: функция функции функцию функций 
анализ: анализа анализ 
представлять: представляет представляют 
комментарий: комментарии 
автоматизировать: автоматизируемый 
размер: размеру 
голос: голосов 
разработчик: разработчики разработчикам разработчиков 
оптимальный: оптимальным оптимальный 
единичный: единичные 
показать: показано 
аппаратный: аппаратном аппаратного 
дорогой: дорогому дорогие 
количество: количества количество 
нижний: нижняя 
вызывать: вызывал 
меню: меню 
тот: тому тех той 
внедрение: внедрения внедрению внедрение 
посмотреть: посмотреть 
который: которыми которые которых который которое котором которого 
автор: автор 
воздействие: воздействию 
сосредотачиваться: сосредотачиваться 
контроль: контроля 
поэкспериментировать: поэкспериментировать 
улучшение: улучшению 
судить: судя 
репозиторий: репозитории 
часть: часть частью части 
скопление: скопление 
глаз: глаза 
продолжать: продолжают 
исчерпать: исчерпан 
охватывать: охватывают охватывает 
ресурс: ресурс ресурсов 
синий: синего 
занятие: занятия занятие 
регрессионный: регрессионное регрессионного регрессионным регрессионных 
оказываться: оказываются 
должный: должна 
средний: средняя 
предотвращение: предотвращения 
именно: именно 
порядок: порядок 
часто: часто 
белый: белый 
начать: начать 
косвенно: косвенно 
набор: наборы набором набора набор 
многий: многими многих 
вручную: вручную 
линия: линией 
возлагать: возлагали 
речь: речь 
тестирование: тестировании тестированию тестирования тестирование 
запуск: запуск запусков 
кейс: кейсы кейсам кейсов кейсах 
обсудить: обсудим 
добавить: добавить 
фикс: фиксы фикс 
дата: даты 
компонент: компоненте компонента компонент компонентах компоненты компонентов 
однако: однако 
ответ: ответы ответов 
объём: объемом 
частый: чаще частым 
нетронутый: нетронутым 
непроверенный: непроверенный непроверенные непроверенная 
помощь: помощью 
рассмотреть: рассмотрим 
такой: такие таком таким такая таких 
являться: являются 
нужно: нужно 
достигаться: достигается 
фреймворк: фреймворках фреймворка 
шанс: шансов 
проблема: проблему проблемы проблемой 
оригинал: оригинала 
находиться: находятся 
исправление: исправлению исправлений 
ход: ходе 
случай: случаях случае 
обеспечение: обеспечения обеспечении 
синь: синей 
приёмочный: приемочные приемочных приемочный 
масштабировать: масштабируемых 
плотность: плотность плотности плотностью 
никто: никто 
отправить: отправить 
сделать: сделать сделан 
подход: подход 
усилие: усилия усилий 
язык: языка языков язык 
требоваться: требуется 
требовать: требует 
запланировать: запланированным запланированной 
дзен: дзен 
дефект: дефект дефектов дефекты 
обнаруживаться: обнаруживаться 
друг: другом 
возможность: возможность 
перевод: перевод 
поздний: позже позднему 
прямо: прямо 
тщательно: тщательно 
выполнять: выполняющие выполняет выполняют 
подтвердить: подтвердить 
существующий: существующего существующие существующих 
прямоугольник: прямоугольники прямоугольник прямоугольниках 
специально: специально 
находить: находить находят находит 
поиск: поиск поиска 
зрение: зрения 
экономически: экономически 
сотня: сотен сотни 
использовать: использовать используем используют использует 
содержать: содержат содержит 
изменение: изменении изменениями изменений изменения 
запоздалый: запоздалые 
карма: карма 
интеграционный: интеграционные 
написание: написание 
результат: результате результатов результаты 
управление: управления 
расти: растут 
цель: целью 
данные: данным данных 
ждать: ждать 
обнаружить: обнаружат обнаружить обнаружили обнаружил 
ценный: ценными 
оптимизация: оптимизации оптимизация 
коммит: коммита 
отправной: отправной 
ситуация: ситуациях 
несколько: несколько нескольких 
место: месте 
файл: файлов файла файл 
нецелесообразный: нецелесообразен 
мосеенков: мосеенкова 
усугублять: усугубляет 
процесс: процессе процесс процесса 
настройка: настройка 
продакшн: продакшн 
оптимизировать: оптимизированный оптимизировать 
десятка: десятки 
сожаление: сожалению 
бросаться: бросается 
два: двумя две 
необходимо: необходимо 
отображать: отображает 
связь: связи 
участок: участки участками 
неудачный: неудачными неудачных 
навык: навыки 
профиль: профиль 
зависимость: зависимости 
измерить: измерили измеренного 
красный: красные красным 
просачиваться: просачивается 
эмпирический: эмпирических 
точка: точкой точки 
маленький: меньше 
применить: применен 
наблюдение: наблюдение 
мучительный: мучительно 
означать: означает 
уровень: уровне 
код: кода коду код 
пять: пяти 
старый: старую 
программирование: программирования 
тридцать: тридцать 
решить: решила решить 
значительно: значительно 
алгоритм: алгоритмы 
предыдущий: предыдущие 
раз: раза 
важный: важны важной 
уделять: уделяли 
создание: созданию 
увидеть: увидеть 
динамика: динамика 
методология: методологии 
пропуск: пропуску 
сторона: стороны 
скрам: скраму 
закрыть: закрыли 
обратиться: обратиться 
компилятор: компиляторов 
трудиться: трудятся 
собирать: собираем собирают 
выстроить: выстроен 
это: это 
начинать: начинать начинают 
написать: написали написаны 
профилировщик: профилировщики 
опыт: опыту 
дополнительный: дополнительное 
вышеупомянутый: вышеупомянутый 
непрерывный: непрерывной 
иметь: имеет 
тест: тестов тестам тесты теста тестами тест 
сравнить: сравнили 
убедить: убедить 
команда: команды командам командах команде команд команда командами 
выпустить: выпустить 
реализовать: реализован 
оставаться: оставался 
этап: этапе 
называть: называем называемые 
получение: получения 
существовать: существуют 
редактор: редактор 
поддержка: поддержка 
отбор: отбора 
сам: сами 
отличие: отличий 
выполнить: выполнены выполненные выполнен 
открытый: открытое 
тестировщик: тестировщиков тестировщики тестировщикам 
сьют: сьюты сьютов сьюта 
противоречивый: противоречивые 
бэклога: бэклоге 
какой: какое каких какие 
один: одном одной 
выявлять: выявляет 
подвергнуться: подвергшихся 
время: временем времени время 
неделя: недели недель 
крупный: крупных 
независимо: независимо 
повышать: повышает повышая 
позволять: позволяет 
хаба: хабы 
несмотря: несмотря 
становиться: становятся 
починить: починить 
картина: картине 
зелёный: зеленые зеленым зеленого 
минута: минут 
проверить: проверены 
массовый: массовые массовый массовых 
образ: образом 
менеджер: менеджеров 
покрытие: покрытия покрытии покрытие 
устранить: устранить 
внутри: внутри 
знать: знать знаем знала 
год: года 
эффективный: эффективными эффективнее 
сломаться: сломалось 
приглашать: приглашаем 
площадь: площадь 
разбор: разбор 
функциональность: функциональность функциональности 
добавлять: добавляют добавлять 
организация: организация организации 
исторически: исторически 
происходить: происходит 
приходиться: приходится 
пустой: пустого 
неэффективный: неэффективен 
придавать: придаем 
дальнейший: дальнейшие 
множество: множества 
прогресс: прогресса 
последний: последнего последним 
слишком: слишком 
малый: наименьшее меньшее 
среди: среди 
принцип: принципе 
серый: серых серым серые 
течение: течение 
идти: идет 
обычно: обычно 
меняться: менялись 
следующий: следующим следующего 
тег: теги 
обратный: обратной 
ссылка: ссылке 
прочтение: прочтение 
опровергнуть: опровергнуть 
испортить: испорчено 
месяц: месяца 
например: например 
читать: читайте 
ксения: ксения 
информационный: информационная 
прежде: прежде 
больший: наибольшее больших 
сбор: сбора 
отказ: отказу 
поэтому: поэтому 
повторяться: повторяется 
поломка: поломкам 
история: история 
пропускать: пропускали 
компания: компании компаниях 
особенно: особенно 
подготовка: подготовкой 
разный: разные разных 
делать: делать 
извлечь: извлечь 
статья: статье 
легко: легко 
сильно: сильно 
глубокий: глубже 
автоматизированный: автоматизированного автоматизированных 
вопрос: вопросы 
релиз: релизу релизом релиз релиза релизе 
отловить: отловить 
возникнуть: возникнуть 
настоящий: настоящей 
расчёт: расчета 
систематический: систематический 
юнит: юнит 
первый: первых 
около: около 
поздно: поздно 
охватить: охвачены 
ручной: ручного ручным ручных 
включать: включает 
исправить: исправить исправлены 
цикл: цикл 
внимание: внимания 
помочь: помочь 
данный: данном данный 
источник: источника 
информация: информацией информацию информации 
недостаток: недостаток 
вывод: выводы 
получить: получить 
пройти: пройти 
приводить: приводит приводящий приводят 
критический: критической критические 
играть: играть 
секунда: секунду 
день: день дней 
высокий: высокой 
среда: среде 
сколько: сколько 
баг: багов баг баги багах 
некоторый: некоторых некоторые 
поддерживать: поддерживает 
негативный: негативные 
низкий: низкой 
выход: выхода 
представить: представлены 
существенный: существенную существенного 
производство: производство 
подкреплять: подкрепляет 
соблазн: соблазн 
смысл: смысле 
назад: назад 
превышать: превышало 
изменить: изменен измененный измененного измененные 
подробный: подробнее 
нетестировать: нетестированная 
перестать: перестать 
затем: затем 
объединять: объединяет объединяем 
странно: странно 
сравнение: сравнению 
хотя: хотя 
вместо: вместо 
остальной: остальных остальные 
необходимый: необходимы 
анализировать: анализировать 
наш: нашему наших 
всевозможный: всевозможные 
записаться: записаться 
понять: понять 
известный: известных 
быстрый: быстрее 
сокращение: сокращения 
трекер: трекеры трекер 
центральный: центральном 
размышление: размышлений 
бюджет: бюджет 
трек: трека 
наиболее: наиболее 
доступный: доступны 
систематически: систематически 
подверженный: подвержены 
этот: эта этих 
непрерывно: непрерывно 
уверенность: уверенность 
критически: критически 
вести: ведет 
большинство: большинство 
бизнес: бизнес 
сить: сьют 
спорить: спорить 
составлять: составляем 
комментировать: комментировать 
ведущий: ведущих 
повторный: повторный 
пробел: пробелы пробелов 
тёмный: темный 
частичный: частичной 
интуитивно: интуитивно 
клиент: клиентов 
оправдывать: оправдывает 
ответить: ответить 
хороший: лучшие хорошей 
выбрать: выбранными выбрать 
недоставать: недостающие 
вчера: вчера 
лёгкий: легче 
ранее: ранее 
второй: вторых 
стать: стали 
редко: редко 
тестироваться: тестируются 
сайт: сайт 
обвинять: обвиняли 
одновременно: одновременно 
покрывать: покрывает 
целое: целом 
тысяча: тысячами тысяч тысячи 
избыточный: избыточные избыточны 
сценарий: сценарий 
мина: мин 
карта: карта карты карте 
центр: центре 
прикладывать: прикладывать 
изобразить: изображена 
сравнительно: сравнительно 
сталкиваться: сталкивались 
сутки: сутки 
измениться: изменился изменились 
увеличиваться: увеличивается 
приступить: приступить 
затрата: затрат 
показывать: показывают показывает 
изображаться: изображается 
вычислять: вычисляем 
хватать: хватало 
функциональный: функциональными 
отображаться: отображается 
появиться: появившиеся 
проанализировать: проанализировать 
убедиться: убедиться 
выше: выше 
соответствовать: соответствует 
уменьшать: уменьшает 
мероприятие: мероприятий 
помогать: помогает помогают 
чёрный: черной 
особенность: особенностей особенности 
каждый: каждом каждый каждую 
обнаружение: обнаружению 
моделирование: моделирования 
пример: примере 
профилирование: профилирование 
протестировать: протестированы 
доступно: доступно 
замедление: замедлению 
масса: массу 
встреча: встрече 
рейтинг: рейтинг 
час: час 
другой: другие других 
вконтакте: вконтакте 
свой: своей 
строка: строку строк 
чей: чья 
проект: проектов проекте 
технический: техническая 
полностью: полностью 
отсутствие: отсутствие 
хотеть: хотят 
обладать: обладает 
отдельный: отдельных 
пока: пока 
группа: группа 
найти: найти 
момент: момента момент 
проверять: проверяют 
изображать: изображает 
либо: либо 
гораздо: гораздо 
закладка: закладки 
занимать: занимает 
инструмент: инструментами 
пора: пор 
эксперт: экспертами экспертов 
похожий: похожие 
вернуться: вернуться 
небольшой: небольшое 
вино: вина 
правый: правой 
себя: собой 
жадный: жадные 
хабра: хабр 
успешный: успешного 
фича: фичах фичей 
обновить: обновить 
правильность: правильности 
деятельность: деятельность 
использоваться: используется 
дать: данные 
сложиться: сложившиеся 
принимать: принимать 
подмножество: подмножество 
узнавать: узнавали 
насыщенный: насыщенного 
состоять: состоящих 
основа: основе 
взвесить: взвешенные 
влияние: влиянии влияния влияние 
стоить: стоит 
просмотр: просмотров 
провести: провести 
прошлый: прошлом 
публикация: публикации 
десяток: десятков 
никакой: никаких 
писать: писать 
решение: решения 
завершение: завершения 
мало: мало 
желать: желающих 
выявление: выявления 
сложный: сложнее 
исторический: исторических 
вина: вину 
половина: половина 
они: ними 
верхний: верхней 
процессный: процессной 
собственный: собственном 
левый: левая 
оба: обеих 
счёт: счет 
отказаться: отказались 
проводить: проводимых 
доля: долей 
проведение: проведения 
цифровой: цифровые 
интеграция: интеграции 
собранный: собранный собранным 
стараться: стараются 
трудно: трудно 
блог: блог 
появляться: появлялись 
быстро: быстро 
смочь: смогут 
вычислить: вычислить 
обсуждение: обсуждение 
уходить: уходит 
пара: пару 
вообще: вообще 
видеть: видим 
последствие: последствия 
очевидный: очевидны 
