процесс: процессы процессе процессу процесс процесса 
система: системе система систем 
задача: задачи задача задач задаче задачами 
опрос: опрос опроса опросов 
приложение: приложения 
готовность: готовности 
свой: своего 
анализировать: анализируйте 
внедрить: внедрить внедрите 
спасибо: спасибо 
совет: совета совет 
качество: качеством качеству качества качестве 
шаблон: шаблонов шаблона шаблон шаблоны 
шаг: шаги шагов шагам 
гугл: гугл 
тестовый: тестовых тестовые 
завести: заведите заведенные 
перевод: перевода 
путём: путем 
чёткий: четкие 
тратить: тратить 
наладить: налаженная 
корректировка: корректировки 
внимание: внимание 
знать: знают 
разработка: разработки разработке разработка 
яндекс: яндекс 
короткий: короткого 
поскольку: поскольку 
распространить: распространенных 
возможно: возможно 
картина: картину 
лист: листов листы 
ожидание: ожиданий ожидания ожидание 
тестировщик: тестировщика тестировщиком тестировщик тестировщиков тестировщики тестировщиками тестировщикам 
состояние: состояний 
провести: проведено проведите 
лишний: лишние 
представлять: представляет 
комментарий: комментарии 
организовать: организовать 
голос: голосов 
начать: начните начать 
разработчик: разработчики разработчикам разработчик разработчиков разработчиками 
случай: случаи случаев случае 
придумывать: придумываете 
описывать: описывайте 
перейти: перейти 
критичный: критичного 
обоснованный: обоснованному 
меню: меню 
должный: должны должна 
тот: тому тех 
стиль: стиль 
автор: автор авторов 
ранний: ранний раньше раннего 
команда: командой команды команде команда 
далее: д далее 
забыть: забыли 
улучшение: улучшения улучшение 
коллега: коллеги 
критерий: критериев критерии 
дать: данная дать 
регрессионный: регрессионное 
именно: именно 
порядок: порядок 
часто: часто 
существенно: существенно 
вид: виду виде 
речь: речь 
низкий: низкий низкого 
тестирование: тестировании тестированию тестирования тестирование 
продумать: продумать продумайте 
ситуация: ситуаций ситуациях ситуации 
кейс: кейсы кейсов кейсах 
добавить: добавить 
правило: правила правил 
оказаться: оказались 
рассмотреть: рассмотрим рассмотрели 
воспроизводиться: воспроизводятся воспроизводится 
описать: опишут описать 
нужно: нужно 
рисковать: рискуете 
песочница: песочницы 
исправление: исправлению исправления исправление 
статус: статусам статусов статусы статусами 
выяснить: выясните 
выпускаться: выпускаются 
построение: построение построения 
обеспечение: обеспечения 
выполнить: выполните 
отправить: отправить 
проверить: проверили 
проанализировать: проанализируйте 
язык: языка язык 
член: членам членов членами 
находиться: находится 
ёжик: ежик 
дзен: дзен 
возможность: возможность 
баг: баге бага багами багов баги 
прод: прод 
следить: следить следите 
поздний: позже 
значительный: значительные 
версия: версией версию версии версия 
итог: итогам 
вика: вики 
три: трех 
поиск: поиск 
приоритет: приоритетов приоритеты приоритета 
оформить: оформите 
попробовать: попробуйте 
программный: программного 
создавать: создают 
избегать: избегать 
карма: карма 
выходить: выходил 
ждать: ждите ждать 
новый: новом 
результат: результате результатов результаты 
работа: работы работу работа 
содержать: содержит 
управление: управления 
несколько: несколько нескольких 
регламент: регламент регламенты регламента 
заключение: заключение заключению 
единственный: единственным 
проблема: проблема проблем проблемами проблемы 
который: которым которых которого 
настройка: настройка 
привет: привет 
выпуск: выпуска выпуск 
профиль: профиль 
писать: пишите 
зависимость: зависимости 
отдельный: отдельный 
обнаруживаться: обнаруживаются 
ошибка: ошибки ошибок 
выбрать: выбранные выберите 
постепенно: постепенно 
повышаться: повышается 
приступать: приступайте 
привычно: привычно 
выполнение: выполнению выполнения выполнении 
решаться: решается 
начало: начала 
рекомендация: рекомендаций 
весь: вся всем 
старый: старую 
хранить: храните 
раз: раза 
общий: общих общую 
личка: личку 
ход: ходом ходу 
он: нему 
готовый: готова 
менеджер: менеджеру менеджером менеджера 
наличие: наличие наличии 
определить: определите определить 
проект: проектами проект проекта проектом проекте 
итерация: итерации итерацию 
высокий: высокий высокого 
сосредоточить: сосредоточены 
удовлетворять: удовлетворяют 
основный: основных основную 
разработать: разработайте 
указать: укажут 
это: это 
подходить: подходят 
вариант: варианта 
текстовый: текстового 
обойтись: обойтись 
экономия: экономия 
требование: требований требованиях 
самый: самых самые 
этап: этапе 
выпустить: выпустить 
поддержка: поддержка 
пропуск: пропуска 
уделить: уделить уделите 
текущий: текущей текущая 
локализация: локализацию 
пример: примеры пример 
выяснение: выяснения 
очередь: очередь 
хаба: хабы 
рамка: рамках 
описание: описания описание описанию 
проектирование: проектирование проектирования 
туман: тумане 
поплоухин: поплоухина 
следующий: следующие следующей 
формироваться: формируется 
звать: зовут 
время: времени время 
пользователь: пользователь 
энтузиазм: энтузиазмом 
список: список списка 
бизнес: бизнеса 
предыдущий: предыдущего предыдущем 
публичный: публичные 
отслеживать: отслеживаете 
исправлять: исправляют исправлять 
заведение: заведение 
форма: формы форме 
приходиться: приходится 
первый: первое первых первую 
нуль: нуля 
исполнение: исполнением 
последний: последнего 
среди: среди 
набор: набору набор 
обычно: обычно 
тег: теги 
ниже: ниже 
минус: минусы 
уровень: уровень 
раздел: раздел 
прочтение: прочтение 
неинформативный: неинформативного 
например: например 
взяться: возьмутся 
задокументированный: задокументированных 
завершить: завершить завершена 
сформировать: сформированного 
минорный: минорный 
коммуникация: коммуникации 
статья: статье статья 
вопрос: вопросы 
специалист: специалист 
релиз: релизу релиз релиза релизы релизов 
слово: словами 
качественно: качественно 
идти: шла 
наглядный: наглядной 
ручной: ручного 
встреча: встречи 
важный: важный важные 
цикл: цикл 
кроме: кроме 
единый: единый 
чек: чек 
получить: получить получите 
иметься: имелось 
правильный: правильной 
база: база 
передача: передачи 
насколько: насколько 
воспроизведение: воспроизведении 
найти: найдете найденные 
строить: строить 
отсутствие: отсутствии отсутствия 
вносить: вносите 
практический: практических 
навык: навыков 
просто: просто 
обратный: обратную 
такой: таком таких 
строиться: строятся 
важно: важно 
чувствовать: чувствуете 
выявить: выявленными 
сценарий: сценарии 
снизить: снизить 
представляться: представляется 
вместо: вместо 
свободный: свободной 
главный: главных 
остальной: остальных 
исполнитель: исполнителей 
оценка: оценки 
документ: документов 
выстроить: выстроите 
развиваться: развивается 
идеал: идеале 
менее: менее 
фича: фич фичам 
установить: установите установить 
предоставлять: предоставляете 
инженер: инженерам инженеров 
сокращать: сокращает 
этот: эта 
уверенность: уверенность 
история: истории 
вести: ведет 
ценность: ценность 
средний: средний 
попадать: попадают 
жизненный: жизненный 
ответить: ответить 
хороший: лучшие 
протестировать: протестирована 
какой: каком 
получать: получает 
вчера: вчера 
добро: добро 
багаж: багаж 
инструмент: инструментов 
информация: информацию 
торопиться: торопитесь 
стадия: стадии стадий 
организация: организации 
переборщить: переборщить 
дело: дело 
мина: мин 
говорить: говорит 
согласовать: согласуйте согласовать согласованный 
решение: решение 
предложить: предложите 
риск: риск 
нормальный: нормальный 
работать: работает работать 
сутки: сутки 
приступить: приступить 
брать: брать берите 
связать: связаны 
отсортировать: отсортируйте 
бумага: бумаге 
канал: канале канала 
лид: лидов 
стартовать: стартует 
вакансия: вакансии вакансий 
назначение: назначения 
преимущество: преимущества 
выше: выше 
постоянно: постоянно 
помогать: помогает помогают 
причина: причин 
планирование: планирования 
данные: данных 
пропускать: пропускать 
вроде: вроде 
важность: важности 
рейтинг: рейтинг 
спешка: спешки 
вы: вами 
подготовить: подготовить 
жц: жц 
один: одной одних 
больший: большую 
введение: введение 
составление: составления 
технический: техническая 
немой: нем 
блокировать: блокирующий 
количество: количество количеством 
называться: называется 
дополнительно: дополнительно 
переход: перехода 
пункт: пункт 
гораздо: гораздо 
вытекать: вытекает 
согласование: согласования 
закладка: закладки 
простой: простой 
подключить: подключить 
приятно: приятно 
похожий: похожие 
вернуться: вернуться 
помочь: помогут 
опросник: опросника 
прерываться: прерываетесь 
подробно: подробно 
ощущение: ощущение 
затрата: затраты 
нести: несет 
спрашивать: спрашивать 
особый: особое 
хабра: хабр 
любой: любой 
сложность: сложности 
сразу: сразу 
момент: момент 
продукт: продукта 
возврат: возврата 
представимый: представим 
учиться: учатся 
обновить: обновить 
два: две 
использоваться: используется 
деталь: деталей 
схема: схемы 
заранее: заранее 
присутствовать: присутствует присутствуют 
основа: основе 
елена: елена 
стоить: стоит 
просмотр: просмотров 
необходимость: необходимости 
стучаться: стучаться 
публикация: публикации 
перечень: перечня 
так: т 
цена: цена 
стенд: стенде 
критический: критический 
завершение: завершения 
внедрять: внедряйте 
вестись: ведется 
связь: связь 
отличие: отличие 
общение: общение 
тесно: тесно 
быть: будут 
вспомнить: вспомнить 
расстановка: расстановке 
грамотный: грамотного 
отвечать: отвечают 
исправить: исправлены 
придерживаться: придерживаться 
основной: основные 
перепроверка: перепроверка 
тест: тест 
установка: установки 
делать: делайте 
сокращение: сокращение 
положить: положите 
мочь: можете 
направление: направление 
