заслуживать: заслуживать 
мочь: могут можем могли 
чувствительность: чувствительности 
общий: общего общую общих общими общая 
поддельный: поддельной поддельным поддельных поддельными поддельные поддельного 
задать: заданное заданного 
область: области 
скрытый: скрытых скрытым скрытого скрытый скрытое скрытые 
стабилизировать: стабилизирует 
путём: путем 
учитывать: учитывая 
частность: частности 
один: одного одно одной одна одним 
поскольку: поскольку 
хороший: лучшего наилучшую наилучшее хорошую хорошее наилучшие наилучшим хороших лучшим наилучших наилучший лучшие лучшая хорошие лучшее 
неполный: неполным неполны 
значение: значение значениям значению значения 
режим: режиме режима 
соответственно: соответственно 
противник: противник 
повышение: повышения 
аппроксимация: аппроксимации 
внедрять: внедряем 
показать: показано показали показаны 
регрессия: регрессия регрессию регрессии 
сходство: сходство 
период: период периода периоды 
май: мая май 
далее: д далее 
пространственный: пространственных 
конфиденциальность: конфиденциальности конфиденциальность 
вызвать: вызванные вызвано 
нагрузка: нагрузку 
часто: часто 
меняться: меняются 
выбирать: выбираем 
декодер: декодера декодер декодере 
цвет: цвет цветом 
использовать: использовали использована использовать использует используем используя 
атака: атака атаке атаки атакам атак 
случай: случаях случаи случаев случае 
иметь: имеют имеет 
плотность: плотность плотностью плотности 
требование: требованию 
требовать: требует 
защита: защитой защиту 
перепись: переписи перепись 
утечка: утечкой утечки 
возможность: возможность возможности 
пытаться: пытаются 
несколько: нескольким несколько нескольких 
доверие: доверия 
наш: нашим нашу наш наших наши нашем нашего нашей наша 
относительно: относительно 
стоимость: стоимость 
контроль: контролем 
изменение: изменении 
управление: управления управление 
потеря: потерей потерям потерь потери 
содержать: содержит содержат 
называть: называемую называем 
обучение: обучения обучении обучение обучением 
данные: данным данными данных 
распределять: распределять 
восстановить: восстановленный восстановить 
прогнозировать: прогнозируем 
прогнозирование: прогнозирования 
низкий: низким низкую низкий 
интегральный: интегральная интегральной интегральную 
регуляризатор: регуляризатор регуляризатора 
рекомендовать: рекомендуемый 
обозначение: обозначения 
зачёт: зачете 
конкретный: конкретными конкретный конкретные 
обученный: обученной обученного 
взрослый: взрослых взрослого взрослый взрослые 
слой: слоям слой слоев слоем слоя 
связка: связки 
контролировать: контролируемое 
предложить: предложено предложил предложенную 
показатель: показателях показателям показателей показатель показатели 
измерить: измерили 
наклон: наклоном наклон 
набор: наборов наборами наборе набора наборы наборах набор 
оценка: оценку оценке оценки 
совместный: совместного совместном совместной 
независимый: независимой независимую 
обрабатывать: обрабатывают 
синтетический: синтетические 
нейронный: нейронных нейронные нейронную нейронной 
базовый: базовые базовыми базовых 
надёжный: надежные надежного надежную 
литературный: литературный 
социальный: социальные социальных 
предварительно: предварительно 
ссылка: ссылки 
генерировать: генерируем генерируя генерируемые генерируют генерирует 
обыкновенный: обыкновенные обыкновенных 
отличительный: отличительных 
предназначить: предназначены предназначен 
решить: решили решив решена 
итерация: итерации итераций 
декомпозиция: декомпозиции 
запись: записям записи записями запись записей 
сравнить: сравнили 
любой: любую 
рекорд: рекордов 
округ: округе 
общность: общности 
доступный: доступные 
разредить: разреженный 
достигать: достигает 
следующий: следующие следующим следующего следующую следующий следующих 
использование: использование использованием использовании 
числовой: числовыми числовым числовые 
год: года лет годы 
список: список 
максимальный: максимального 
метод: методах методом метода методам методами методов методы метод 
проблема: проблем проблемы проблемой проблему 
синтез: синтезу синтез синтеза синтезе 
множество: множества множество 
качество: качестве качества качеством качество 
изучить: изучить изучено 
среди: среди 
хотеть: хотим 
расстояние: расстояния расстоянию расстояние 
классовый: классовых классовую классовая классовой 
полагаться: полагаемся 
категориальный: категориальными 
дифференциальный: дифференциально дифференциальные дифференциальных 
поэтому: поэтому 
визуализация: визуализация 
максимально: максимально 
производительность: производительности производительность 
синий: синих синим синие 
уравнение: уравнениях уравнение уравнении уравнения уравнений 
тот: ту 
определять: определяет 
снижать: снижали 
сша: сша 
снижение: снижении 
разный: разных разными 
ковалевский: ковалевского 
медицинский: медицинских 
компромисс: компромисс 
элемент: элемент элементу 
передача: передачи передаче 
роль: роль 
результат: результата результатам результат результаты результатов 
генератор: генератора генератор генератором генераторе 
рис: рис 
механизм: механизм 
объединить: объединить 
тестирование: тестирования тестировании 
сочетать: сочетает 
препятствовать: препятствуют 
таблица: таблицу таблице таблицы таблиц таблицах 
подходящий: подходящую подходящее 
эксперимент: экспериментах экспериментов эксперименты эксперимента 
чтение: чтения 
точка: точек точки 
реальный: реальном реальная реального реальными реальную реальных реальные реальной реальным 
характеристика: характеристик характеристику 
синтезировать: синтезируют синтезировать синтезируем синтезирует синтезированную 
интегрировать: интегрированную интегрируем интегрировать 
столбцы: столбцы столбцами столбцов 
линейный: линейная линейной 
усреднять: усредняем 
уменьшение: уменьшения уменьшение уменьшением уменьшении 
классификация: классификации классификация классификацию 
сложность: сложность сложности 
такси: такси 
аппроксимировать: аппроксимирует 
создание: создании создание 
история: истории 
произведение: произведение 
уровень: уровней уровни уровень 
связующий: связующим 
клиент: клиентов 
выполнять: выполняем 
прошлое: прошлым 
биективный: биективными 
аналогично: аналогично 
одномерный: одномерный 
корректный: корректна 
обратимый: обратимой обратимая обратимую обратимых обратимым обратимого обратимые 
средний: среднее средние 
класс: классов класс класса 
достижение: достижения 
такой: таким такое такие таких 
связанный: связанных связанный связанные 
сутки: сутки 
похожий: похожа похожих похожи похожие 
переменный: переменной переменных 
кодер: кодере кодер кодера 
двоичный: двоичной двоичную двоичная 
зелёный: зеленым 
большой: большое велики 
равный: равен равным равна 
основать: основанная основаны основанных основанные основанный основана 
близкий: близки 
этот: этих эта этому 
интеза: интез 
обмен: обмену 
полный: полных полные полный полной 
следуемый: следуем 
соответствовать: соответствует 
состязательный: состязательные состязательное состязательным состязательной состязательного 
сравнивать: сравниваем 
модель: моделям моделью модель моделей модели 
якобиан: якобиана якобиан якобианов якобианы 
резюмировать: резюмировать 
аналитический: аналитическая аналитическими аналитическим 
кош: коши 
условный: условных 
рейтинг: рейтинг 
приложение: приложениями приложении приложение приложению приложений 
отметить: отметим 
настраивать: настраиваем 
параметр: параметра параметров 
получить: получили получены получил 
введение: введение 
сложно: сложно 
дополнительно: дополнительно 
разделять: разделяет 
аннотация: аннотация 
таксон: таксона 
вернуться: вернуться 
гауссиана: гауссиан гауссиане 
эффективно: эффективно 
себя: собой 
объединять: объединяем объединяет 
работа: работа работе 
вакансия: вакансий вакансии 
единичный: единичного 
микро: микро 
обновить: обновить 
интегрироваться: интегрируются 
предварительный: предварительных предварительной 
использоваться: используется используются 
время: время времени 
изменить: изменена 
среда: средах среды 
создать: созданном 
табличный: табличные табличного табличными табличным табличных 
публикация: публикации 
потенциальный: потенциальной 
так: т 
второй: вторая вторые 
пометить: помеченные 
предлагать: предлагаемая предлагаем предлагаемой предлагаемого предлагаемый предлагаемые предлагаемую 
компания: компанией 
сверточный: сверточных сверточного 
обучать: обучающих обучающий обучаем 
корректировка: корректировке 
принс: принса 
радиус: радиусу 
основное: основном 
статус: статуса 
подчёркивать: подчеркивающий 
разделить: разделить 
тысяча: тысячи тысяч 
вычислить: вычислить вычислена 
временной: временную временных временная временные 
тип: типов типа тип 
кредит: кредит кредита кредиты 
структура: структура структуру структуре 
абляция: абляции 
свойство: свойству свойств 
различный: различных различными различные 
вывод: вывод выводы 
архитектура: архитектур архитектуры архитектура архитектуре архитектуру 
плохой: хуже плохие 
яндекс: яндекс 
шрифт: шрифтом 
ключевой: ключевым ключевых 
строка: строка 
комментарий: комментарии 
маловероятный: маловероятно 
размерность: размерность размерности 
голос: голосов 
столбец: столбец столбцу столбца столбцам столбце 
сигнал: сигнал сигнала 
гиперпараметр: гиперпараметры 
связать: связан связана связано 
сигмоидальный: сигмоидальную 
точный: точную 
оценочный: оценочные оценочных 
задача: задача задач задачей задачу задачи задачах 
состоять: состоящие состоит 
часть: часть 
именно: именно 
скалярный: скалярному 
непрерывный: непрерывный непрерывным непрерывного непрерывными непрерывные непрерывных 
являться: являются является 
обозначить: обозначенные 
исследование: исследование исследования исследований 
сделать: сделать 
требоваться: требуется 
узел: узлы узлов 
нелинейный: нелинейная нелинейные 
цель: целей цель целью 
жертвовать: жертвует жертвовать 
поиск: поиск 
сообщать: сообщаем 
выбрать: выбранном выбранный 
эйлер: эйлера 
свой: свои 
автоэнкодер: автоэнкодера автоэнкодер 
увеличение: увеличение увеличением увеличении увеличения 
который: которым которых который которой которую которые которая 
настройка: настройка настройку настройками 
успешный: успешных 
место: места 
вероятность: вероятности вероятностей вероятность 
следовательно: следовательно 
теорема: теоремы теореме 
правильно: правильно 
активация: активация 
моделирование: моделирование моделирования 
ошибка: ошибки ошибок 
ряд: рядов ряды 
пространство: пространства пространстве пространство 
считаться: считаются 
аналитически: аналитически 
ограничение: ограничение ограничений ограничения 
драйвер: драйвер 
продажа: продажи 
распространение: распространение распространения 
алгоритм: алгоритмы алгоритме алгоритм 
кодировщик: кодировщик 
дискретный: дискретные дискретных дискретным дискретными 
разделение: разделение 
сторона: стороны 
отрицательный: отрицательную отрицательным отрицательные отрицательной отрицательная 
это: это этим 
принять: принято 
реализовать: реализован реализовать 
успешность: успешности 
обучить: обучить 
явный: явным 
входной: входной входного входные 
форма: формой форму формами 
обновлять: обновляем 
доход: доходом доходов 
тщательный: тщательные 
способствовать: способствовать 
инвариантный: инвариантная 
векторный: векторное 
разумный: разумных разумные разумную разумный 
неясно: неясно 
становиться: становится 
дормана: дормана 
делать: делая 
описать: опишем 
направление: направлении направлений 
условие: условий 
непроверенный: непроверенными 
соединение: соединение 
обратный: обратном 
вариационный: вариационные вариационной 
первый: первых 
рабочий: рабочую 
путь: путь пути 
минь: мини 
ограничить: ограничены 
репозиторий: репозиториях 
обобщённый: обобщенную 
влияние: влиянию 
опубликовать: опубликованных 
дискриминатор: дискриминатора дискриминатору дискриминатор 
приводить: приводит приводим 
просто: просто 
сгенерировать: сгенерированный сгенерировать 
оригинальный: оригинальных 
взаимодействие: взаимодействий 
предложный: предложен 
процедура: процедуре процедуры 
податливость: податливости 
многомерный: многомерного 
также: также 
работать: работают работает 
преобразовать: преобразуем преобразует 
цена: цены 
обратить: обратите 
гауссов: гауссовой гауссова 
программный: программных 
некоторый: некоторые некоторых 
комментировать: комментировать 
достаточно: достаточно 
погрешность: погрешности 
матрица: матрицы 
извлечь: извлеченной извлечь 
вычисление: вычисления 
ориентировать: ориентированные ориентированную ориентированных 
вводить: вводим 
генеративный: генеративных генеративные генеративной 
следовать: следует 
красный: красным красных 
простота: простоты 
гипер: гипер 
ориентироваться: ориентируясь 
мина: мин 
решение: решение решения решений решениях 
сложный: сложной 
гровер: гровер 
логарифмический: логарифмическую логарифмической логарифмические логарифмическая 
функция: функцию функция функцией функций функции 
коэффициент: коэффициентом коэффициент 
отрицательно: отрицательно 
исключение: исключением 
уменьшать: уменьшает 
выделить: выделенный выделены 
улучшать: улучшает 
ограничивать: ограничивают 
радемахер: радемахера 
ссылаться: ссылаемся 
ограниченный: ограниченных 
машинный: машинное машинного 
информация: информации информацию 
два: двух две 
популярный: популярных 
регуляризация: регуляризация регуляризацию регуляризации 
отдельно: отдельно 
остальной: остальные 
дифференцирование: дифференцирования 
момент: момента момент моментом 
дальнейший: дальнейшего 
принимать: принимает 
др: др 
высокоточный: высокоточному 
отклонение: отклонение отклонения отклонением 
тестировать: тестируем 
версия: версия версию 
внедрить: внедрено внедрили 
язык: язык языка 
определённый: определенный 
основа: основе 
просмотр: просмотров 
скрыть: скрытом 
выигрывать: выигрывает 
завершение: завершения 
фактически: фактически 
вариация: вариаций вариации 
определение: определений определение 
мара: мар 
предпочтительно: предпочтительно 
сначала: сначала 
оценивать: оцениваем 
последствие: последствия 
весь: весь всем 
определяться: определяется 
прежний: прежнему 
оранжевый: оранжевым 
простой: простых простой 
представлять: представляем представляют представляет 
логарифм: логарифмов 
влиять: влияет 
тестовый: тестовых 
аппаратный: аппаратных 
подчёркивание: подчеркиванием 
различать: различать 
оптимальный: оптимальное 
внимание: внимание 
липшица: липшицу 
напрямую: напрямую 
обратиться: обратитесь 
каждый: каждой каждое каждого каждый 
человек: человеком людьми 
жирный: жирным 
меню: меню 
проверять: проверяющими 
улучшить: улучшил улучшить 
описывать: описывает описываем 
труд: труда 
размер: размер размера размеры 
лежать: лежащая 
малый: малом меньшим 
важный: важных 
реконструкция: реконструкцию 
несбалансированный: несбалансированных 
однако: однако 
точно: точно 
помощь: помощью 
извлекать: извлекать 
интересно: интересно 
генерироваться: генерируются 
другой: другими других другие 
дзен: дзен 
гласить: гласит 
суммировать: суммируем 
увеличивать: увеличивая 
сервисный: сервисной 
одинаковый: одинаковое одинаковы 
мотивация: мотивация 
четыре: четыре 
эффективный: эффективный 
точность: точность точностью 
карма: карма 
реалистичный: реалистичную реалистичные реалистичных 
перекрываться: перекрываются 
распределение: распределение распределений распределения распределениями 
означать: означают означает 
генерация: генерации 
недавно: недавно 
привести: приведены приведена 
диапазон: диапазоны 
изометрический: изометрическую 
профиль: профиль 
зависимость: зависимости 
определитель: определителя определителей 
недавний: недавняя 
ансамбль: ансамблях 
номер: номера номерами 
согласно: согласно 
отсев: отсева 
максимизировать: максимизировать 
б: б 
сеть: сети сеть сетей сетях 
скорректировать: скорректировать 
частый: частая 
значительно: значительно 
собственный: собственных 
преобразование: преобразования 
неоптимальный: неоптимальным 
эквалайзер: эквалайзера 
гауссиан: гауссианов 
провести: провели 
тыс: тыс 
новость: новости 
получение: получения 
существовать: существуют существует 
поддержка: поддержка 
обзор: обзор 
начальный: начальными 
быть: е будут 
пример: примеры 
противоположный: противоположных 
регрессионный: регрессионные 
позволять: позволяет 
отсесть: отсев 
хатчинсон: хатчинсона 
якоби: якоби 
выглядеть: выглядит 
знать: знать 
зависеть: зависящих зависящей 
инвариантность: инвариантности 
дом: домов 
ящик: ящик ящика 
считать: считаем 
устойчивость: устойчивостью устойчивость 
тег: теги 
конфиденциальный: конфиденциальную конфиденциальные 
какой: каких 
например: например 
легко: легко 
статья: статье статьях статьи 
подход: подходов подход подхода 
агрегатор: агрегатором 
варьироваться: варьируется 
пять: пятью пять 
термин: терминах 
балл: баллы 
высокий: высокой высоким высоки 
исходить: исходя 
кубический: кубическую 
текущий: текущая 
присущий: присущие 
исходный: исходных 
изменять: изменяя изменяем 
ставить: ставя 
акция: акций 
удалить: удалили 
хотя: хотя 
автоматический: автоматического 
недостаточно: недостаточно 
выходной: выходной выходного выходные 
наиболее: наиболее 
упорядочивать: упорядочивает 
протекать: протекающий 
процесс: процесс процессе процесса 
анализ: анализ 
подготовка: подготовку 
затруднять: затрудняет 
пусть: пусть 
рекурсивный: рекурсивное 
статистика: статистику 
целое: целом 
дело: дело 
заяц: зайцев 
увеличиваться: увеличивается 
давать: дает 
вектор: вектор вектора векторе векторы вектором 
соответствие: соответствии 
рисунок: рисунок рисунке 
активный: активному 
рассматривать: рассматривать рассматриваем 
устойчивый: устойчив 
последний: последний последних последние 
стандартный: стандартное стандартным 
пакет: пакета 
немного: немного 
й: й 
окончательный: окончательный 
технический: техническая 
литература: литературе 
полностью: полностью 
немой: нем 
оценить: оценить 
количество: количество количества 
найти: найти 
вариант: вариантов вариант 
либо: либо 
гаусс: гаусса 
предполагать: предполагаем 
закладка: закладки 
занимать: занимает 
цифра: цифры 
консенсус: консенсус 
показывать: показывает показывают показываем 
многие: многие 
край: края 
минимальный: минимальный 
включить: включить 
дать: данные 
индийский: индийской 
сэкономить: сэкономить 
никакой: никаких 
тангенс: тангенс 
модуль: модулей 
гиперболический: гиперболический 
обозначать: обозначающий 
прогресс: прогресс 
преимущество: преимущество 
однозначный: однозначными 
решать: решают 
они: ними 
единый: единую 
тесно: тесно 
ая: ае 
мерный: мерное 
собираться: собирается 
нормализация: нормализации 
таксономия: таксономия 
дерево: деревья 
единственный: единственное 
обобщить: обобщены 
обработка: обработки 
демонстрировать: демонстрирует демонстрируют 
восстанавливаться: восстанавливается 
представление: представления представление 
уменьшить: уменьшив 
считывать: считывает 
долл: долл 
автор: автор 
взять: взято 
улучшение: улучшения 
ухудшение: ухудшение 
раздел: разделе 
доказывать: доказывает 
добавить: добавить 
концепция: концепцию 
статистический: статистические 
рассмотреть: рассмотрим 
оригинал: оригинала 
находиться: находятся находится 
экспериментальный: экспериментальные 
выборка: выборки 
вклад: вклад 
перевод: перевод 
чёрный: черного черный 
зрение: зрения 
располагаться: располагаются 
смотреть: см 
лишь: лишь 
банковский: банковского 
незначительный: незначительном 
делиться: делиться 
разностный: разностный 
проводить: проводим 
население: населения 
макро: макро 
правдоподобный: правдоподобные 
оптимально: оптимально 
пропорция: пропорцию 
конструкция: конструкции 
продвинуть: продвинутую 
самый: самый самых 
король: король 
старый: старую 
демографический: демографической 
заключительный: заключительное 
обучаться: обучается 
многий: многих 
обнаружить: обнаружили 
сиэтл: сиэтле 
уникальность: уникальности 
правдоподобие: правдоподобия 
кинг: кинг 
хаба: хабы 
существующий: существующие 
автокодер: автокодеры 
образ: образом 
восстановление: восстановления 
конкатенация: конкатенацию 
разнородный: разнородный 
проект: проект 
метрика: метрику 
повышать: повышая 
большинство: большинстве 
слишком: слишком 
создавать: создает 
течение: течение 
множественный: множественной 
обычно: обычно 
преодолеть: преодолеть 
прочтение: прочтение 
благодаря: благодаря 
рассчитать: рассчитать рассчитана 
дополнительный: дополнительные 
слово: словами 
решатель: решателями 
проверка: проверки 
включать: включает 
помочь: помочь 
кроме: кроме 
различие: различий 
положительный: положительным 
наличие: наличии 
затем: затем 
сравнение: сравнению 
двоякий: двоякая 
байесовский: байесовские 
представимый: представима 
превосходить: превосходят превосходит 
обеспечивать: обеспечивает 
подраздел: подразделе 
нормализовать: нормализованному 
разнообразный: разнообразной 
строго: строго 
процессор: процессор 
задумать: задумано 
выгода: выгоду 
вывести: выведены 
усиление: усиления 
отображение: отображения 
подробный: подробные 
актуальный: актуальной 
выстрел: выстрелом 
смесь: смеси 
правило: правило 
доступно: доступно 
автодекодер: автодекодера 
угроза: угрозу 
заключаться: заключается 
классификационный: классификационных 
проектирование: проектирования 
проводиться: проводились 
метка: метки 
хабра: хабр 
проецирование: проецирования 
отчёт: отчета 
беспристрастный: беспристрастной 
аналитик: аналитик 
уважаемый: уважаемых 
убийство: убийство 
изучать: изучаемом 
широкий: широкое 
вычислительный: вычислительные 
взаимно: взаимно 
активно: активно 
