говориться: говорилось 
мочь: могут мог можем можете могли могло могу 
признать: признанным 
версия: версий версиях версию 
чтение: чтении чтения 
улучшаться: улучшалась 
накладный: накладные 
потребоваться: потребоваться потребуется 
вывод: выводу вывода выводе 
упомянуть: упомянул 
область: области 
исход: исходом 
путём: путем путём 
администратор: администраторы администраторов администратора администратору администратором администратор 
продемонстрировать: продемонстрированное продемонстрировать продемонстрировано продемонстрированы 
являться: являюсь являются являющейся является 
один: одного одно одной одну одна одним 
жёсткий: жесткого 
поскольку: поскольку 
значение: значение значения значений 
доказать: доказать 
сценарий: сценарием сценариях сценарий сценариев сценарии 
наверняка: наверняка 
режим: режиме режима режим 
соответственно: соответственно 
ваш: вашей ваши вашего вашу ваших ваше 
позволить: позволите позволит 
упоминаться: упоминается 
необходимый: необходимые необходимое необходимого 
видный: видна 
инфраструктура: инфраструктуре инфраструктуру 
показать: показано показать показан показанной показав показаны показанному 
страница: страницу страницы страница страниц странице страницах 
должный: должны должно должна должен 
период: период 
команда: командой команды команде команду командах команда команд 
контроль: контроля 
неизвестно: неизвестно 
рулетка: рулетку 
копия: копиями копий копии копия копию 
системный: системные 
любой: любое любых любом любого любые любой 
вдохновлять: вдохновляют 
перестроение: перестроением 
шаг: шагов 
предпочтительный: предпочтительным предпочтительнее 
часто: часто 
вид: виду вид виде 
дело: деле 
распределять: распределяет 
запуск: запуск запуска 
полный: полную полное 
сообщение: сообщение сообщений сообщения 
сам: самой сама самом само самому 
приводить: приводить приводит приводят 
число: чисел числе числа 
восстановиться: восстановиться 
эксперт: эксперт экспертом 
нужный: нужной нужную нужен 
случай: случаях случая случаев случай случае 
иметь: имеют иметь имеющая имейте 
ожидать: ожидает 
поговорить: поговорим 
разработчик: разработчиках 
возможность: возможность возможностью возможности 
полюбоваться: полюбоваться 
категория: категории 
проявиться: проявится 
прозрачный: прозрачным 
относительно: относительно 
сервер: сервер сервера 
глубоко: глубоко 
опция: опции опцией 
крайний: крайнем крайней 
взгляд: взгляд 
дополнительный: дополнительных дополнительными дополнительные 
работа: работы работа работу 
потеря: потерей потеря потере потери 
содержать: содержит содержащей содержать содержащую 
обучение: обучения 
имя: имени именем имя 
значительный: значительным 
отчёт: отчет отчета 
источник: источников 
несколько: несколько нескольких 
далее: далее 
исправление: исправление исправления 
сделать: сделал сделали сделать 
проникнуть: проникнуть 
отключить: отключить 
справиться: справиться 
подправить: подправил 
выбор: выбором 
поделиться: поделюсь 
создавать: создавая создает 
интересный: интересное интересны 
существование: существования 
портить: портит 
последний: последнему последняя 
аварийный: аварийного 
обнаружение: обнаружение обнаружения обнаружении 
равносильно: равносильно 
флаг: флаг флагом флагами 
ссылка: ссылки ссылке 
разместить: размещена 
ошибка: ошибках ошибка ошибки ошибок 
транзакция: транзакции 
сезам: сезам 
название: названием названия 
уровень: уровня уровне уровнем уровень 
повреждение: повреждениях повреждением повреждение повреждений повреждении повреждения повреждению повреждениями 
закрой: закрою 
предложить: предложить 
применить: применить 
сведение: сведению сведения 
заметить: заметить 
попасть: попасть попадут 
похожий: похожее похожему похожие 
умирать: умирает 
выпустить: выпустить выпустим 
русский: русскую 
какой: какое каком каких какие 
выполнить: выполнил выполнена выполнить выполню 
холодный: холодном 
синтаксис: синтаксис 
восстановить: восстановлена восстановлены восстановить 
процент: процентов процент 
ядро: ядра 
говорить: говорил говорит говорю говорят 
товарищ: товарищу 
год: года лет 
состояние: состояние 
список: список 
александр: александр 
совместимость: совместимости 
основный: основная 
умолчание: умолчанию 
использоваться: использовался используется 
устранение: устранение устранению устранения устранением устранении 
свирепый: свирепый 
удар: удар 
сбой: сбои сбоя сбой 
меткий: метким 
проблема: проблем проблемах проблемы проблемой проблему 
повредить: поврежден поврежденные повредило поврежденными повреждена поврежденная поврежденной повредить повреждённые поврежденных повреждённая повредили повреждены поврежденного 
гровер: гровером гровер 
качество: качестве 
индекс: индексов индексу индексы индекс индексе индекса 
начальник: начальника начальнику 
веский: вескую 
хотеть: хотим хотели хочу 
контрольный: контрольную контрольной 
следующий: следующим следующую следующее следующей 
прежде: прежде 
рассчитывать: рассчитывать 
поэтому: поэтому 
предупреждение: предупреждения 
подменить: подменить подменив 
формат: формате 
утверждение: утверждения 
возникнуть: возникнуть 
резервный: резервное резервную резервной резервного резервная резервные резервных 
определять: определяет 
подробный: подробных 
читать: читать читаете 
получить: получим получить получите 
разный: разных разный 
передача: передачи 
конкретный: конкретное конкретной 
насколько: насколько 
паника: паника 
пугать: пугающее пугающим 
сколько: сколько 
кластерный: кластерный 
файл: файле файл файлы файлом файла 
рис: рис 
решить: решить 
тестирование: тестирования 
такой: такого таким такую такое такие такая таких 
руководитель: руководителя 
таблица: таблицу таблице таблица таблицы таблиц 
новый: новому новую новой нового новая новый новые новых 
выполнение: выполнения выполнение выполнении 
серьёзный: серьезную серьезный серьезная серьезной 
вскоре: вскоре 
недокументированный: недокументированной недокументированных 
последующий: последующее последующем 
работать: работаете работающего 
повторный: повторное повторный повторного 
вставить: вставленных вставим вставлены 
история: истории 
трассировка: трассировки 
незапятнанный: незапятнанную 
зависеть: зависеть 
подсистема: подсистемы подсистеме подсистем 
переоценить: переоценить 
масштаб: масштаба 
действовать: действовать 
важность: важность 
ранее: ранее 
второй: вторых вторая 
попытаться: попытаюсь 
узнавать: узнавать 
одновременно: одновременно 
подобный: подобный подобных подобного подобными 
нанести: нанести нанесет 
выполнять: выполняло выполняет 
начать: начнем 
впадать: впадает 
связанный: связанных 
детализация: детализации 
сутки: сутки 
знакомый: знакомы 
большой: большое 
равный: равен 
иначе: иначе 
угрожать: угрожает 
увидеть: увидели увидеть 
монстр: монстром монстров монстр монстру монстра 
этот: этих эта этому 
форма: форм 
запись: записи запись записей 
соответствовать: соответствует 
быть: будем будете будут буду 
прибегнуть: прибегнуть прибегнете 
содержимое: содержимое 
остаться: останутся останется 
причина: причин причину причина причины 
повторно: повторно 
запрос: запроса 
объём: объём 
рейтинг: рейтинг 
посреди: посреди 
вы: вами 
параметр: параметра параметр параметром параметров 
далёкий: дальше 
строка: строку строк строка строки 
способ: способа способ способы 
отсутствие: отсутствие 
остановить: остановить 
ущерб: ущерб ущерба 
роль: роли 
указываться: указывается 
возвращаться: возвращаются 
просмотр: просмотра просмотре просмотров просмотр 
считать: считаю считает 
уметь: умеет умеете уметь 
довольно: довольно 
вредительство: вредительства 
чудовище: чудовище чудовищами 
шоу: шоу 
открывать: открывать открываю 
сочувствовать: сочувствую 
вернуться: вернуться 
небольшой: небольшое 
возможный: возможных возможным возможные 
себя: собой 
вакансия: вакансий вакансии 
сложность: сложности 
объект: объекта объекты объектов объект 
запомнить: запомнить 
исследовать: исследовать 
потенциально: потенциально 
обновить: обновить обновите 
тот: той те тому тех 
воспользоваться: воспользоваться воспользуюсь 
куча: куче кучу кучей 
отсутствовать: отсутствующих 
время: время времени 
операция: операции 
выходить: выходят 
сумма: суммы сумму 
отпадать: отпадает 
листинг: листинге листинг листинга 
стоить: стоит 
милый: милый 
публикация: публикации 
победить: победить 
отметить: отмечу отметить 
тривиальный: тривиального 
однажды: однажды 
злодеяние: злодеяние 
информация: информация информации информацией информацию 
указатель: указателя 
обнулить: обнулить обнулив 
переместиться: переместиться 
причинять: причиняет 
индикатор: индикатором 
листовой: листовом листового 
глава: главы 
проигнорировать: проигнорированы 
ммент: ммент 
незаметный: незаметным 
точный: точна 
пробный: пробный пробную 
основное: основном 
основной: основные 
выводить: выводимый выводимой выводимых вывожу 
временной: временную 
релиз: релизе 
плохой: плохая наихудшим худшим 
скрипт: скрипта скрипт скриптов скрипты 
извлечение: извлечения 
рука: руках 
различный: различных 
видеть: вижу видеть видим видели 
простой: простые простою простого простую простым простое проще прост простой 
перебор: перебора 
доступность: доступности 
документированный: документированной 
долгий: долгое 
база: базы база баз базам базе базах базу 
яндекс: яндекс 
разница: разницы 
погружение: погружения 
обнаружить: обнаружите обнаружено обнаруженных обнаружит 
представить: представлен представленного представлено 
знать: знаете знаем знаю 
частый: частого чаще 
комментарий: комментарии 
блок: блоке блок 
голос: голосов 
регулярный: регулярные регулярного 
план: планов планы плана 
проявление: проявлению 
посмотреть: посмотреть посмотрим посмотрю 
прочитать: прочитанной 
возвращать: возвращаемых 
часть: часть части 
конец: конце 
другой: другим других другие другое другую 
находить: находящего нахожу 
пользовательский: пользовательских 
удивление: удивлением 
именно: именно 
заполнение: заполнение заполнению заполнения 
речь: речь 
вставлять: вставляет 
проявить: проявить 
шестнадцатеричный: шестнадцатеричный шестнадцатеричное шестнадцатеричном шестнадцатеричного шестнадцатеричные шестнадцатеричных 
оставлять: оставлять 
погнать: погнали 
идея: идея 
цель: целей 
подвергаться: подвергалась 
создать: создал создать создан созданы создано создадим 
обратиться: обратится обратимся 
загрузка: загрузки загрузка 
поиск: поиск поиска поисках 
событие: событий 
результат: результате результат результатах результаты результатами результатов 
свой: свои свое своему своем своей своего 
операционный: операционной 
ждать: ждать 
основать: основанных 
написать: написать 
истолковать: истолковать 
поверхностно: поверхностно 
сегодня: сегодня 
настройка: настройка 
сей: сих 
место: места место 
несогласованный: несогласованная 
проверить: проверите проверенной проверенных проверенные 
пол: пол пола 
неделя: неделями 
мачете: мачете 
детализировать: детализировать 
пространство: пространства 
плохо: плохо 
иной: иные 
начало: начала 
облегчить: облегчит 
разработать: разработанный 
книга: книгу книги 
дубликат: дубликатами 
мир: мире мир 
доступный: доступна 
получать: получают 
приносить: приношу 
её: её 
неопытный: неопытных 
это: это этим 
обнуление: обнуление обнуления 
старый: старый старую 
ознакомиться: ознакомиться 
вариант: вариантах вариантов варианта варианты вариант 
использование: использования использовании 
деталь: детали 
некластерный: некластерных некластерный некластерного некластерные 
перестроить: перестроены 
своевременный: своевременного 
диск: диску диска диске диск 
распоряжение: распоряжении 
ага: ага 
означать: означать означает 
несмотря: несмотря 
рассказать: расскажу 
регулярно: регулярно 
настать: настало 
происходить: происходят происходит 
туториал: туториал 
определить: определить 
дисковый: дисковой дисковых 
кружка: кружкой 
переработка: переработкам 
середина: середине 
нуль: нуля 
становиться: становится 
обратный: обратной 
средство: средства средств средствами 
оно: оно 
завершить: завершить 
прийти: прийти 
обдуманно: обдуманно 
двигаться: двигаться 
командын: командынам 
оператор: оператора 
первый: первых первая первый 
термин: термины 
смягчить: смягчить 
фактический: фактические 
принять: приняв 
данные: данными данных 
задача: задачей 
данный: данном данную данный 
который: которых который которое которой которую котором которые которая 
действительно: действительно 
таков: таково 
автоматизация: автоматизации 
просто: просто 
дамп: дамп 
всё: всё 
просматривать: просматривать 
редактор: редакторе редактор редакторов 
внести: внести 
удалить: удалить 
причём: причем причём 
оценка: оценки 
использовать: использовал использовать используемым использую использует используя 
драматичный: драматичен 
также: также 
заводь: заводь 
являетсякучий: являетсякучей 
тревожный: тревожным 
педантичность: педантичность 
подготовить: подготовленным подготовленный 
мы: нам 
обратить: обратите 
потерять: потерял потеряны потеряли 
некоторый: некоторые некоторый некоторых 
комментировать: комментировать 
найти: нашел найти найдено найденного найдём 
достаточно: достаточно 
спрятаться: спрятаться 
вычисление: вычисления 
запустить: запустить запущена запустив 
следовать: следует 
улица: улицы 
выполнимый: выполним 
откатиться: откатиться 
баллон: баллоне 
мина: мин 
решение: решение решении 
состоять: состоит 
позволять: позволяют позволяет 
усовершенствование: усовершенствований 
тонировать: тонированными 
давать: давайте 
указывать: указывающий указывает указывало 
выделение: выделению 
смочь: сможете смогу сможем сможет 
иллюстратор: иллюстратор 
идентификатор: идентификатор 
безопасный: безопасного 
функция: функцию функций 
убедиться: убедиться 
физический: физическом 
выходной: выходных 
задать: задав 
возвратить: возвращенное 
вероломный: вероломное 
южанин: южане 
опасность: опасности 
изучение: изучения 
служба: службу 
два: двух две 
находиться: находиться находятся 
отдельно: отдельно 
называться: называется 
упрощённо: упрощённо 
момент: момента момент моментом 
эзотерический: эзотерические 
инструмент: инструмент инструменты инструмента инструментов 
принимать: принимает 
появиться: появились появится 
рекомендовать: рекомендовал рекомендовано 
контроллер: контроллер контроллера 
сигнал: сигналом 
верно: верно 
борьба: борьбы 
изобразить: изображено 
сразу: сразу 
согласованность: согласованности согласованность 
оборудование: оборудования 
представимый: представим 
необходимость: необходимость 
привносить: привносит 
корневой: корневой 
надеяться: надеюсь надеется 
погружаться: погружаться 
язык: язык языка 
основа: основе 
оставаться: оставаться 
восстановление: восстановлению восстановлении восстановление восстановления 
показывать: показываю показывает показывают 
мало: мало 
загрузить: загрузить загрузил загруженные 
выявление: выявления 
аналогичный: аналогичные 
документировать: документирована 
утратить: утраченных 
обычный: обычный 
номер: номер 
восстановимый: восстановимую 
резюме: резюме 
привести: приведёт приведет привести 
надёжный: надежной 
изменить: изменить изменены 
расход: расходы 
кислород: кислорода 
относиться: относится относящиеся 
быстро: быстро 
обеспечить: обеспечить обеспечит 
включить: включенным включить 
запросить: запросить запрошенной 
мара: мар 
страшный: страшную 
сначала: сначала 
последствие: последствия 
помогать: помогают помогали 
важный: важным важную важной важный 
система: системе системы 
реальность: реальности 
сообщать: сообщать 
аппаратный: аппаратных 
мера: мерам мер мере 
гладченко: гладченко 
внимание: внимание 
разработка: разработки 
добиться: добиться 
возможно: возможно 
общий: общей 
совершить: совершить 
нечитаемый: нечитаемой 
напомнить: напомним 
удаться: удастся 
подробность: подробности 
копирование: копирования копирование 
меню: меню 
помимо: помимо 
включая: включая 
забыть: забыли 
отключение: отключением отключения 
затронуть: затронуло затронуты затронули 
попутно: попутно 
распределить: распределены 
защита: защита защиты 
идентичный: идентично 
однако: однако 
оказаться: оказались 
помощь: помощью 
видно: видно 
катастрофа: катастрофой 
интересно: интересно 
ухайдакать: ухайдакаю 
пожалуйста: пожалуйста 
предположим: предположим 
смириться: смириться 
дзен: дзен 
физически: физически 
устать: устану 
карма: карма 
игра: игре 
рабочий: рабочее рабочего 
многое: многое 
узнать: узнанного узнать 
шок: шок 
сообщить: сообщит сообщить 
недавно: недавно 
нравиться: нравится 
отвечать: отвечает 
предварительный: предварительного 
отображать: отображает 
измениться: изменится 
профиль: профиль 
разумеется: разумеется 
уголок: уголок 
добавить: добавлены добавить 
техника: техникой 
выдаваться: выдаваться 
очаровательный: очаровательным 
фатальный: фатальным 
пробегать: пробегает 
невозможно: невозможно 
недоступный: недоступна 
собственный: собственных 
предыдущий: предыдущие 
электронный: электронной электронном 
наличие: наличие 
почта: почты 
записывать: записываемые 
ограничить: ограничен ограничить 
пустой: пустой 
заполнить: заполнены 
описывать: описывал 
понятно: понятно 
бегло: бегло 
получение: получения 
поддержка: поддержка 
предпринять: предпринять 
подмена: подмены 
весьма: весьма 
опустеть: опустеет 
структура: структуру 
понимание: понимании 
тема: тема тему теме 
починить: починить 
расследование: расследование 
непосвящённый: непосвященного 
выделить: выделены 
выглядеть: выглядит выглядят 
устранить: устранить устранена 
вне: вне 
против: против 
забрать: забрал 
рамка: рамки рамках 
вплоть: вплоть 
извинение: извинения 
предпоследний: предпоследняя 
тег: теги 
попадание: попадания 
научиться: научились 
повредиться: повредиться 
исправлять: исправлять 
офис: офис 
просмотреть: просмотреть 
например: например 
продолжить: продолжить 
вызвать: вызвано 
легко: легко 
статья: статье статьи 
непосредственно: непосредственно 
семейство: семейством 
идти: идите 
успешный: успешное 
стратегия: стратегии 
поздно: поздно 
очень: очень 
хороший: наилучший лучшие хорошие хорошая хорошей 
батарейка: батарейку 
сопоставлять: сопоставлять 
цифра: цифра 
итак: итак 
столкнуться: столкнется столкнуться 
цепочка: цепочки 
кошмар: кошмаром 
высокий: высокой высоким 
условие: условии 
напоминать: напоминать 
иметься: имеется 
бесплатный: бесплатны бесплатный 
хотя: хотя 
журнал: журнале 
фиксировать: фиксирует 
отказ: отказом отказов 
известный: известных 
занятие: занятие 
помочь: поможет помочь 
упоминать: упоминал 
собираться: собираюсь 
стать: стало стать 
менее: менее 
противостояние: противостояние 
наш: нашем нашей 
хотеться: хочется 
я: мной 
прийтись: придется 
средний: средний 
неполадка: неполадок 
завершение: завершение 
верный: верный 
существо: существу 
корзина: корзину 
редактировать: редактировать 
рассчитать: рассчитано 
произойти: произошло произойдёт произойдет 
самый: самым самых 
пусть: пусть 
ринуться: ринуться 
длительный: длительному 
местоположение: местоположение 
понимать: понимать 
пиво: пива 
оба: оба 
бояться: бойтесь 
сталкиваться: сталкивались 
обязательный: обязательный 
оперировать: оперируя 
заголовок: заголовок 
соответствие: соответствии 
связать: связаны 
весь: всем 
отправлять: отправляет 
изменение: изменения изменение 
выбрать: выбрав выберем 
выше: выше 
вещь: вещи 
рисунок: рисунок рисунке 
углубиться: углубились 
метод: методов 
неизменный: неизменными 
впечатляющий: впечатляющий 
разместиться: разместился 
немного: немного 
демонстрация: демонстрация 
проверка: проверку проверок проверки 
технический: техническая 
записываться: записывается 
количество: количество 
пока: пока 
многочисленный: многочисленных 
либо: либо 
гораздо: гораздо 
проверяться: проверяется 
восполнение: восполнения 
закладка: закладки 
понадобиться: понадобится 
пора: пор 
неисправность: неисправности 
многие: многие 
рассмотреть: рассмотрели рассмотрим 
неведение: неведении 
долго: долго 
позаботиться: позаботиться 
храниться: хранится хранилось 
минимальный: минимальный 
попадать: попадать 
пот: поту 
стекло: стёклами 
пойти: пойдёт 
столбцутаблица: столбцутаблицы 
дать: данные 
код: коде код 
целый: целую 
коснуться: коснусь 
распространиться: распространятся 
пример: примера пример примере 
экземпляр: экземпляров экземпляра 
рэндать: рэндала рэндал 
отличие: отличие 
значить: значат 
скоро: скоро 
превратиться: превратятся 
исправить: исправлены исправить 
ярость: ярость 
вообще: вообще 
информативный: информативными 
взять: возьмём 
поздний: поздних 
удаление: удаление 
реальный: реальных 
поделать: поделать 
демонстрировать: демонстрирует 
представлять: представляет представляющее 
полезный: полезен полезным полезных 
автор: автор 
факт: факту факт 
конкретно: конкретно 
восстанавливать: восстанавливать 
существенный: существенное 
предотвращение: предотвращения 
нечто: нечто 
обслуживание: обслуживания 
ужас: ужасов 
исправный: исправные 
предполагать: предполагая 
нужно: нужно 
оригинал: оригинала 
стена: стену 
равно: равно 
хранение: хранения 
смертельный: смертельный 
инициализировать: инициализировать 
подчёркивать: подчеркиваю 
тихий: тихим 
ожидаться: ожидалось 
ночь: ночи 
перевод: перевод 
прямо: прямо 
корректно: корректно 
существовать: существует 
лишь: лишь 
избыточный: избыточными 
размещение: размещения размещение 
целостность: целостность целостности 
сущий: сущим 
немедленно: немедленно 
опасный: опасное опасный 
совершенно: совершенно 
расшифровка: расшифровки 
высовывать: высовывает 
процесс: процессе процессу процесса 
нижний: нижней 
новость: новостью новость 
сожаление: сожалению 
включать: включать включает 
возникать: возникает возникают 
сотня: сотнях 
убийца: убийцей 
открываться: открывается 
образец: образец 
проверять: проверять 
запускать: запускать запускаю 
незамеченный: незамеченным 
предстоять: предстоит 
актуализировать: актуализировать 
род: рода 
встретить: встретить 
контролировать: контролируемом 
образоваться: образовалось 
гибкость: гибкости 
множество: множество 
хаба: хабы 
распределение: распределения 
образ: образом 
быстрый: быстрого 
разорвать: разорванных 
ещё: ещё 
вспомнить: вспомним 
незаметно: незаметно 
неповреждённый: неповрежденное 
очистить: очищена 
большинство: большинстве большинство 
слишком: слишком 
течение: течение 
снова: снова 
обычно: обычно 
политика: политики 
подлог: подлог 
прочтение: прочтение 
фал: фале 
вмешательство: вмешательство 
голова: голову 
главный: главной 
однопользовательский: однопользовательском 
недра: недра 
счастие: счастью 
устранять: устранять 
рад: рад 
синхронизировать: синхронизировать 
контекст: контексте 
механизм: механизма 
поддерживать: поддерживаемым поддерживает 
кроме: кроме 
актуальный: актуальная 
указать: указать 
практический: практических 
безусловно: безусловно 
нормально: нормально 
подобие: подобием 
питание: питания 
важно: важно 
затем: затем 
объединять: объединяет 
обеспечение: обеспечению 
вместо: вместо 
продумать: продуманного 
всевозможный: всевозможные 
рекомендоваться: рекомендуется 
сохранить: сохраню 
потерянный: потерянных 
связаться: свяжитесь 
буква: букву 
администрирование: администрирование 
критически: критически 
восьмой: восьмой 
создание: создание 
реакция: реакция 
отдельный: отдельные 
настроить: настроить 
сосредоточиться: сосредоточиться 
аспект: аспектах 
ограниченный: ограниченную 
документация: документации 
забиться: забиться 
кой: коем 
день: дней 
коэффициент: коэффициент 
разбудить: разбудит 
интерфейс: интерфейсам 
отсылать: отсылал 
вычисляться: вычисляется 
одиночка: одиночку 
каждый: каждый каждую 
настолько: настолько 
синхронизация: синхронизация 
решать: решать 
процедура: процедуры 
заключаться: заключается 
письмо: письме 
безвозвратно: безвозвратно 
выдержка: выдержка 
таблицыкоторать: таблицыкоторая 
официально: официально 
имитировать: имитируя 
подробно: подробно 
хабра: хабр 
производительность: производительность 
проиндексировать: проиндексированной 
аббревиатура: аббревиатуры 
рекомендация: рекомендации 
присутствовать: присутствует 
описываться: описывается 
внешний: внешнее 
уважаемый: уважаемых 
намного: намного 
майкрософт: майкрософт 
повезти: повезло 
доверять: доверяете 
специальный: специальную 
драйвер: драйверу 
сказать: сказать 
электропитание: электропитания 
очевидный: очевидно 
отличный: отличный 
порекомендовать: порекомендовать 
вместе: вместе 
делать: делайте 
