весь: весь всем всей 
ваш: ваш вашей вашим вашем ваши вашу вашего ваша ваших 
потратить: потратите 
структура: структура структуру 
задача: задачи задача задаче 
конкретный: конкретную конкретному 
возникнуть: возникнут 
придумать: придумать 
свой: своего свой свои своему своих своей 
оставить: оставить оставьте 
плавный: плавным 
крошка: крошки 
являться: является 
зачастую: зачастую 
продажа: продаже продаж 
постараться: постарайтесь 
смочь: смог сможете 
простой: простую прост простым простой 
подсказка: подсказка подсказок 
внимание: внимание 
подумать: подумаете 
разработка: разработки 
выбор: выбора выбор 
яндекс: яндекс 
сложный: сложны сложный сложные 
получиться: получится 
метод: методы метод методам методов 
пойти: пойти 
значение: значение 
картина: картину 
память: памяти 
будущее: будущем 
хороший: наилучшую хорош лучшие хорошего хороша 
подходить: подходит 
сам: самого самому 
второе: второе 
шаг: шагом шаг 
компьютер: компьютеру 
каждый: каждой каждого каждый 
служить: служить служат 
семантический: семантическую семантических семантической семантическая 
знать: знаете 
беспокоиться: беспокоиться 
представлять: представляет 
один: одну одним одна одной 
комментарий: комментарии 
неестественный: неестественный 
класс: класс классы класса классам классов 
голос: голосов 
заметка: заметку 
написать: написал написать 
прийти: пришло 
считывать: считывает 
количество: количества количество 
меню: меню 
связать: связан 
должный: должны должен должно 
ментальный: ментальный ментальной ментальную ментальные ментально 
формировать: формируете формирует 
различный: различные 
помимо: помимо 
функция: функции функциях функций 
расшибиться: расшибетесь 
велосипед: велосипедов 
далее: д 
перечислить: перечислены 
синтаксический: синтаксическую синтаксической 
переменный: переменные переменная переменных переменную 
писать: пишете пишу 
конец: конце концов 
зарегистрироваться: зарегистрироваться 
начинать: начинаете 
охватывать: охватывают 
ориентировать: ориентированного ориентированное ориентированный ориентированному 
поиск: поиске поиск поисках 
назвать: названа назовем 
программист: программиста программисты 
дедлайн: дедлайн 
функциональный: функциональном 
именно: именно 
голова: голове 
знание: знанием 
часто: часто 
именование: именованием именование 
учитывать: учитывать 
вид: виду 
дело: деле 
решение: решением решениях решения 
хватить: хватить 
фрагмент: фрагменты фрагмент фрагмента 
ситуация: ситуаций 
кейс: кейсы кейсов 
полный: полную полный 
имя: именем имена имени имен имя 
добавить: добавить 
согласный: согласны 
опубликовать: опубликовано 
очевидный: очевидных 
однако: однако 
попытаться: попытаться 
рассмотреть: рассмотрим 
такой: такие 
нужно: нужно 
проблема: проблему проблема проблем проблемы 
интересно: интересно 
описывать: описывающее описывающую 
изобретение: изобретение 
случай: случаях 
расстояние: расстояние 
определённый: определенную 
равно: равно 
поговорить: поговорим 
сделать: сделать сделано 
подход: подход подходом 
лес: лесу лес 
язык: языка язык 
который: которые которой которая который которую которому которого 
вклад: вклад 
дзен: дзен 
поверьте: поверьте 
гласить: гласит 
ночь: ночи 
возвращаться: возвращаетесь возвращаюсь 
статья: статью 
перевод: перевод переводе 
поздний: позже позднем 
замысел: замысла замысел замысле 
тщательно: тщательно 
мой: моем мою моему 
зловещий: зловещим 
зрение: зрения 
тот: те ту той 
использовать: использовать используете используемых 
переходить: переходите 
причина: причине 
правильный: правильный правильной 
лишь: лишь 
код: кодом кода коду код коде 
оставлять: оставляя оставляете 
избегать: избегать 
перевести: переведите перевести 
карма: карма 
решающий: решающее 
мера: мере 
прозрачность: прозрачность 
множество: множеству 
принцип: принцип принципа принципов 
совершенно: совершенно 
построить: построить 
идти: идете 
несколько: несколько 
объяснять: объясняли 
называть: называть называйте 
комплекс: комплекс 
вороной: вороного 
файл: файлов 
предоставить: предоставьте 
адекватный: адекватные 
заключение: заключение 
процесс: процессе процесс 
настройка: настройка 
сей: сих 
ответственность: ответственности 
необходимо: необходимо 
быть: суть 
некоторый: некоторого некоторые 
вполне: вполне 
навык: навыки 
профиль: профиль 
связка: связки 
тёмный: темным 
правильно: правильно 
предполагать: предполагаемые предполагали предполагаемых 
тарабарщина: тарабарщина 
программирование: программированию программирования программирование программировании 
искусство: искусства 
алгоритм: алгоритмов алгоритмы алгоритм 
выбирать: выбираете 
уведомлять: уведомляет 
ник: нику 
остальной: остальной остальным 
воспроизвести: воспроизвести 
самый: самый самые 
полнота: полноте 
старый: старую 
этот: этому этих 
общий: общих 
он: нему 
сторона: стороны 
чрезвычайно: чрезвычайно 
дата: дату 
г: г 
основный: основных 
группирование: группирование группирования 
ноябрь: ноября 
это: это 
просмотреть: просмотрев 
иметь: имеет иметь имело имейте 
ясный: ясное 
полезный: полезными 
использование: использования использование 
этап: этапе 
скачок: скачок 
любой: любую любой 
существовать: существуют 
туманный: туманным 
редактор: редактор 
поддержка: поддержка 
нетрудно: нетрудно 
тест: тесты тест 
предоставлять: предоставляют 
формирование: формированием 
применимый: применимо 
пример: примеры примеров 
вернуться: вернетесь вернуться 
сформировать: сформировали сформировать 
ряд: ряд 
рефакторинг: рефакторингу 
основываться: основываться 
логичный: логичным 
путать: путайте 
почему: почему 
опыт: опыт 
свежий: свежа 
скорее: скорее 
пригласить: пригласить 
позволять: позволяет 
очередь: очередь 
хаба: хабы 
рамка: рамках 
модель: модель моделей модели моделью 
мочь: могу можете 
добавлять: добавляйте 
структурировать: структурировать 
предпочитать: предпочитаю 
важный: важной 
проектирование: проектирование проектирования 
стандартный: стандартных стандартные 
смысл: смысла смысл 
человек: человека 
база: базу 
синтаксис: синтаксис 
короткий: короткое 
подобный: подобных 
близкий: ближе 
особый: особая особое 
думать: думать думаем 
выглядеть: выглядит 
время: времени время 
понимание: понимание пониманию 
ярко: ярко 
обратно: обратно 
подробный: подробное подробнее 
случайный: случайной 
пренебрегать: пренебрегаем 
практика: практике 
устранение: устранение 
происходить: происходит 
кандидатский: кандидатской 
массив: массива 
переход: переход 
паттерн: паттернов паттерны паттернам 
черта: черт 
слишком: слишком 
воссоздать: воссоздать 
начать: начал 
плохой: плохой 
самоописательный: самоописательным 
достигнуть: достичь 
продумывать: продумывать 
снова: снова 
становиться: становится 
обычно: обычно 
говорить: говорили 
тег: теги 
предметно: предметно 
уровень: уровень 
прочтение: прочтение 
благодарность: благодарность 
месяц: месяца месяцев 
прежде: прежде 
поэтому: поэтому 
неделя: недель 
максимально: максимально 
компания: компании 
легко: легко 
реальный: реальную 
показаться: покажется 
нелегко: нелегко 
повезти: повезет 
серьёзно: серьезно 
способность: способности 
около: около 
путь: путь 
очень: очень 
технически: технически 
взглянуть: взглянет 
включать: включает 
осмыслить: осмысленные 
кроме: кроме 
единый: единый 
книга: книга книгой 
разный: разных 
сводиться: сводится 
часть: частью части 
вызывать: вызывают 
итак: итак 
недостаток: недостаток 
получить: получить 
недоумение: недоумения 
действительно: действительно 
насколько: насколько 
лежать: лежащем 
мозг: мозгов 
приобретать: приобретаете 
модно: модно 
решить: решить решит 
просто: просто 
место: место 
делать: делаете делает 
важно: важно 
просматривать: просматривать 
назад: назад 
замечательный: замечателен 
осветить: освещенному 
перестать: перестать 
затем: затем 
версия: версию 
элегантность: элегантности 
обслуживание: обслуживании 
вместо: вместо 
молодёжный: молодёжно 
следующий: следующий следующему 
обнаружить: обнаружил 
известный: известные известных 
понять: понять 
больший: большего большей 
помочь: поможет 
казаться: казался казалось 
стараться: старайтесь 
чётко: четко 
дорога: дорогу 
написание: написания 
предельно: предельно 
последующий: последующее 
поддаваться: поддается 
стать: стало стала 
точнее: точнее 
цель: цели цель 
первый: первую первой первым 
уделять: уделяет 
ясно: ясно 
целостный: целостным 
превратить: превратить 
работать: работаете 
янг: янгу 
зацепка: зацепок 
пожалеть: пожалейте 
левенштейн: левенштейна 
мы: нам 
восстановить: восстановить 
прийтись: придется 
первоначально: первоначально 
ведущий: ведущих 
точка: точки 
завершение: завершение 
достаточно: достаточно 
клиент: клиентов 
короче: короче 
побрать: побери 
вариант: варианты 
почитать: почитайте 
прибегать: прибегаю 
пытаться: пытаетесь пытаемся 
новый: новые 
неизвестный: неизвестные неизвестного 
вчера: вчера 
лёгкий: легче 
соединять: соединять 
следовать: следует 
баг: баг 
нарушить: нарушило 
сайт: сайт 
первоначальный: первоначального 
задумываться: задумываться 
представить: представить представьте 
мина: мин 
состоять: состоит 
удаление: удаления 
веб: веб 
бесплатный: бесплатный 
достижение: достижения 
связанный: связанных 
давать: давайте 
сутки: сутки 
комбинация: комбинации 
сплоховать: сплоховали 
смотреть: смотрю 
состояние: состоянии 
большой: большое 
наглядный: наглядным 
применение: применений 
вряд: вряд 
преимущество: преимуществ 
моделировать: моделируем 
урок: урок 
интервью: интервью 
авторитетный: авторитетная 
затронуть: затронем 
абстрактный: абстрактную абстрактного 
разработчик: разработчиков 
запись: записи 
рассуждать: рассуждать 
уменьшать: уменьшает 
изобретать: изобретаете изобретаем 
сотня: сотни 
правило: правило 
данные: данных 
объяснить: объяснены 
существующий: существующих 
хотеть: хотите хочу 
рейтинг: рейтинг 
позволить: позволят позволит 
выбрать: выбрать 
вконтакте: вконтакте 
спустя: спустя 
откос: откос 
сложно: сложно 
проект: проектов 
технический: техническая 
предполагаться: предполагается 
достаточный: достаточную 
немой: нем 
настолько: настолько 
ясность: ясности 
элемент: элементов 
пока: пока 
найти: найти 
изменение: изменение 
считать: считаю 
либо: либо 
гораздо: гораздо 
идейный: идейном 
довольно: довольно 
диссертация: диссертацией 
закладка: закладки 
изначально: изначально 
понадобиться: понадобится 
форма: форма 
параметр: параметров параметр 
пора: пор 
перерыв: перерыва 
похожий: похожие 
надлежащий: надлежащим 
естественный: естественный 
хлебный: хлебные 
себя: собой 
завтра: завтра 
хабра: хабр 
полагаться: полагаетесь 
ульви: ульви 
программа: программы 
именовать: именовать 
сложность: сложности 
видеть: видеть 
вновь: вновь 
элегантный: элегантен 
обновить: обновить 
разобраться: разобраться 
сконцентрироваться: сконцентрироваться 
вносить: вносит 
основа: основе 
стоить: стоит 
просмотр: просмотров 
публикация: публикации 
так: т 
понятный: понятен понятный 
склонный: склонны 
узнать: узнать 
дейкстра: дейкстры 
объект: объектом 
набор: набор 
звучать: звучит 
появляться: появляются 
пост: посте 
единственный: единственной 
рассчитывать: рассчитывает 
произведение: произведением 
обязательно: обязательно 
сопоставить: сопоставить 
разбросать: разбросаны 
вспомнить: вспомнить 
объединение: объединение 
эксперт: экспертов 
гулиев: гулиеву 
разбивка: разбивку 
счёт: счет 
устаревать: устаревают 
психология: психологии 
цифровой: цифровые 
дать: дать 
основное: основном 
изменить: изменить 
трудно: трудно 
налог: налог 
настоящий: настоящему 
блог: блог 
быстро: быстро 
реконструкция: реконструкции 
создание: создания 
замечать: замечать 
объектный: объектно 
час: часов 
обсуждение: обсуждение 
мнемонический: мнемонический 
диаграмма: диаграмма 
прослеживаться: прослеживается 
нацелить: нацелен 
сначала: сначала 
другой: других 
повторяться: повторяющиеся 
