подарить: подарили 
мочь: могут можем могли могла 
график: графику 
частота: частотой частоте частоты частоту 
программка: программку 
вывод: выводу вывода вывод выводам выводе выводы 
применение: применения 
поведение: поведению 
скрытый: скрытых 
красный: красными красного 
изображение: изображение изображения 
друг: друга друг 
подключить: подключён подключить подключили подключённый подключим подключены 
работать: работали работать работает 
последовательный: последовательный последовательных 
один: одного одному одно одну 
короткий: короткого короткое 
поскольку: поскольку 
приобрести: приобрести 
сработать: сработал сработало сработать 
значение: значение значения 
малый: малая наименьшим 
дорогостоящий: дорогостоящих 
доработать: доработать 
память: памяти память 
режим: режиме 
координата: координатах 
проводы: проводов 
повышение: повышения повышение 
показать: показано покажет 
должный: должны должна должен 
интересный: интересных интересной 
репозиторий: репозитории 
экран: экранов экран экрану экране 
безопасность: безопасности 
рядом: рядом 
прошивка: прошивка прошивки 
часто: часто 
дело: деле 
закоротиться: закоротится 
запуск: запуск запуска запуске 
сам: самой сама самом 
использовать: использовали используемый используют использовать использует используем 
атака: атака атаки атакам атак 
понимать: понимают понимаю 
иметь: имеют имела иметь имеет 
ожидать: ожидает 
сброс: сбросом сброса сброс 
бесполезный: бесполезный 
схема: схема схему схемах схеме схемы 
скачок: скачков скачка 
падать: падает 
автор: авторы автор 
электроника: электроники электроника 
питание: питание питанию питания 
относительно: относительно 
курс: курс курсов курсы 
сервер: сервер 
злополучный: злополучный 
вопреки: вопреки 
сглаживание: сглаживания 
идея: идею 
реализация: реализации 
пожарить: пожарите 
изменение: изменении изменениям изменений изменения 
употребить: употреблен 
взгляд: взгляд 
остаться: осталась остались 
наладить: наладить 
процессорный: процессорное 
работа: работы работу 
внимательно: внимательно 
поставить: поставил 
несколько: несколько несколькими 
факт: факты 
отключить: отключить отключена 
обозначение: обозначения обозначение 
член: членов 
вполне: вполне 
удобно: удобно 
перевод: переводе перевод 
писать: пишите пишет писать 
замысел: замыслу 
цп: цп 
печатный: печатная печатной печатных печатную 
нагрев: нагрева 
набор: наборов набора набор 
обходиться: обходится 
подвал: подвале 
серийно: серийно 
выполнение: выполнению 
купить: купил купить 
аргумент: аргумента аргумент 
высокий: высокое 
микроконтроллерный: микроконтроллерная 
задний: задняя заднем задней задний заднюю 
шкала: шкале 
запитываться: запитывается 
прикрепить: прикреплена 
уровень: уровня уровней уровни уровень 
ювелир: ювелира 
кирпич: кирпич 
частый: частое 
инженер: инженер 
моп: моп 
процент: процента процент 
устройство: устройство устройств устройствами устройства 
написать: написали написано 
подтвердить: подтверждено подтвердили 
умение: умения 
доступный: доступен 
сторона: сторону стороне сторона 
команда: команды команду команда 
объём: объёма 
сигнал: сигналов сигнал сигнала 
положение: положения 
готовый: готовым 
кристалл: кристалла 
разварка: разварке 
оксид: оксида 
рука: рукой 
стираться: стирается 
надеяться: надеялись надеюсь 
стек: стек 
меняться: меняться 
защита: защиту защита защиты 
разрабатываться: разрабатывалась 
другой: другого другим других другая другие другое 
получиться: получилось 
поверхностный: поверхностные 
переменный: переменного 
внутри: внутри 
ядро: ядра ядро 
пользователь: пользователь 
состояние: состояние состоянии 
список: список 
сломать: сломать сломаете 
умолчание: умолчанию 
собирать: собирать собираю 
передний: передняя передний передней 
антенна: антенну антенны 
приходиться: приходится 
качество: качестве 
изучить: изучить 
сообщество: сообщества 
тиристорный: тиристорный 
паразитный: паразитных паразитным паразитными паразитная паразитные 
неработающий: неработающее 
включение: включении включения 
дисплей: дисплеев дисплей дисплеях дисплея дисплеи 
глючить: глючить глючим 
задокументированный: задокументированные 
исполнять: исполняет 
раздел: раздел 
игра: играх игр 
поэтому: поэтому 
нуль: нулями нулю нуле 
вопрос: вопросы вопросом 
озаглавить: озаглавлена 
основа: основ 
стереться: сотрётся 
электричество: электричества 
глитч: глитчей глитч глитча 
регистр: регистра регистр 
цикл: цикл 
неактуальный: неактуальных 
логический: логическом логических логическое логической 
роль: роль роли 
слегка: слегка 
расстроиться: расстроился 
такой: такого таким такие такая 
производство: производство 
два: двум 
вскоре: вскоре 
наш: наш нашими нашего 
позиционирование: позиционирования 
казаться: кажется 
открыться: открылось 
стереть: стереть стёр 
чтение: чтения 
товар: товаров 
точка: точек 
месяц: месяцев 
конструктор: конструктора 
уязвимость: уязвимостях уязвимости уязвимость 
неясность: неясности 
повод: поводу 
ясно: ясно 
омлет: омлет 
техописание: техописание техописаниях 
элемент: элементы элементов элементами 
низкий: низком низкое 
отладчик: отладчиком отладчик отладчика отладчике 
побайтный: побайтная 
первый: первой первых первый 
обмен: обмена обмен 
отработать: отработанные 
значимый: значимым 
элементный: элементной 
перенести: перенесены 
подразумеваться: подразумевается 
плата: плат платы плате плата плату платой 
считывание: считывание считывания считывании 
встроить: встроенное встроенных 
прийтись: пришлось 
второй: вторых 
метод: методом методы 
неожиданный: неожиданному 
подать: подать подан 
фон: фоном 
риск: риск риском 
вспомнить: вспомнил 
материал: материалу 
сутки: сутки 
мера: меры 
остальной: остального остальные 
замыкание: замыкания замыкание 
ёмкость: ёмкость ёмкости 
поменять: поменяв 
запись: записи 
выполнить: выполнена выполнить 
быть: будем е будут 
постоянно: постоянно 
батарея: батареи батареей батарея 
подаваться: подаваться подаётся 
рейтинг: рейтинг 
составлять: составляет 
уязвимый: уязвимо уязвимы 
параметр: параметра параметры параметров 
число: числом 
далёкий: дальше 
дорожка: дорожек 
больший: большим большей 
выяснить: выяснить 
цвет: цвета 
соответствовать: соответствующей 
указываться: указывается 
считать: считаю считать 
стёртый: стёртая стёрта стёртой 
заведомо: заведомо 
довольно: довольно 
отличаться: отличается 
обстоятельство: обстоятельство 
полупроводниковый: полупроводниковые полупроводниковым 
вернуться: вернуться 
битный: битный битную 
себя: собой 
счёт: счёт счёте 
таки: таки 
сложность: сложности 
развязка: развязка 
проект: проекте 
обновить: обновить 
тот: той тех 
скачка: скачками 
использоваться: используется 
время: время времени 
длительность: длительность длительности 
стоить: стоит 
публикация: публикации 
свойство: свойство 
неубедительно: неубедительно 
постоянный: постоянную 
цоколёвка: цоколёвка цоколёвки 
неполный: неполный 
указатель: указателя 
определённый: определённых определённого 
копия: копий 
разделить: разделены 
подача: подачи 
беспроводный: беспроводной 
способ: способами способ способы 
синхронизация: синхронизации синхронизация 
достаточный: достаточной 
продвигаться: продвигаясь 
опубликовать: опубликована 
скорость: скорость скоростью 
выглядеть: выглядеть выглядит 
заземление: заземление заземления 
транзистор: транзистор транзистора 
разрешить: разрешена 
конденсатор: конденсатору конденсатор 
приоритет: приоритетами 
заполняться: заполняется 
битый: биты бит 
установка: установки 
го: го 
отладочный: отладочной отладочные отладочных 
задать: задать 
вероятно: вероятно 
наносекунда: наносекунд 
железо: железа 
запретить: запрещённых 
таймер: таймер 
база: базы базе 
содержать: содержащая 
яндекс: яндекс 
нужный: нужны нужное нужен нужный 
автоматически: автоматически 
напряжение: напряжением напряжения напряжение 
медленно: медленно 
подходить: подходит 
досадный: досадное 
комментарий: комментарии 
маловероятный: маловероятно 
подозревать: подозреваю 
голос: голосов 
хотеть: хотел хотели 
профессия: профессий профессия 
посмотреть: посмотреть 
идти: идёт 
задача: задача задачу задачи 
часть: часть частей части 
единица: единиц единице 
затворный: затворного 
сообщаться: сообщалось 
правда: правда 
спонтанно: спонтанно 
речь: речь 
взлом: взлом взлома 
адрес: адреса адресу 
раскрывать: раскрывает 
подключение: подключения подключение 
ранний: раньше 
отметить: отмечен 
кодовый: кодовое 
контур: контур 
внешний: внешнего 
цель: целей целью 
странный: странным 
поиск: поиск поиску 
слой: слоями слои 
простота: простота 
прогонять: прогонять 
выполнять: выполняет 
ответ: ответам ответу ответ ответы 
чёрно: чёрно 
обращать: обращает 
инструкция: инструкциям инструкция инструкцию инструкциях инструкции инструкций 
старший: старший 
который: которым который которое которой которую котором которые которая которого 
настройка: настройка 
успешный: успешных успешного успешный успешными 
место: места место местах 
заменить: заменит 
корпус: корпуса 
обычный: обычных 
ценник: ценника ценник ценники ценниками 
корректный: корректные корректным 
периферия: периферию 
сглаживать: сглаживает 
проектирование: проектировании проектирование 
программирование: программирования 
операционный: операционного операционный 
алгоритм: алгоритмы алгоритм 
понадобиться: понадобятся 
её: её 
длина: длина 
сошлифовать: сошлифовал 
это: это 
эксплойт: эксплойт эксплойты эксплойта 
старый: старый старую 
неустранимый: неустранимые 
фреймворк: фреймворк 
наблюдать: наблюдали 
эффект: эффектам эффектах эффект 
поликремниевый: поликремниевым 
деталь: детали 
практичный: практичной 
рч: рч 
стирание: стирания стирание 
изобразить: изобразить 
слоёный: слоёный 
хороший: лучший лучшие 
микроконтроллер: микроконтроллере микроконтроллера микроконтроллер микроконтроллеру 
результат: результат 
сопутствовать: сопутствующего 
фотография: фотографии 
математик: математика 
повысить: повысить 
металлизация: металлизации 
загрузить: загружена 
магазин: магазинах 
форма: формы форма 
ток: тока 
структура: структурах структуры структуру 
становиться: становится 
блокировка: блокировкой блокировка блокировки 
условие: условием 
совет: совет 
земля: землю 
средство: средства 
яйцо: яиц 
внутренний: внутренней внутренним внутренняя внутреннему 
оригинал: оригинале оригинала 
заново: заново 
оно: оно 
инжиниринг: инжиниринг 
обратный: обратном обратное 
ровно: ровно 
странность: странностях 
повторный: повторная 
данные: данными данных 
данный: данном 
тело: тела 
источник: источника источником источнику 
предлагать: предлагают 
расходоваться: расходуется 
приводить: приводит 
онлайн: онлайн 
называть: называемые 
взаимонезависимый: взаимонезависимыми 
содержимое: содержимого 
просто: просто 
всё: всё 
поддержание: поддержания 
установить: установлен установили 
процедура: процедуре 
программный: программный 
потребоваться: потребовалась 
написание: написания 
слить: слитый 
также: также 
реализовать: реализовано 
физический: физической 
мгц: мгц 
буфер: буфер 
анализатор: анализаторе 
этот: эта этими этому 
мы: нам нами 
программа: программе 
проходить: проходить проходит 
некоторый: некоторые 
прямой: прямого прямое 
отложить: отложено 
байт: байта байтов байт 
шанс: шансы 
мина: мин 
суть: сути 
эффективность: эффективности 
идентификатор: идентификатор 
три: трёх 
евро: евро 
бояться: боясь 
разработчик: разработчик разработчикам 
стремительно: стремительно 
выпаять: выпаять выпаяем 
исключение: исключением 
страх: страх 
тактовый: тактовую тактовой 
чувствительный: чувствительна 
оснастить: оснастить 
маршрутизация: маршрутизации 
видимый: видимых 
свести: сведёт сведена 
план: планом планам плане 
обойти: обойти 
разработка: разработка разработки 
весь: всей весь всему вся 
разборка: разборки 
надежда: надежде 
изначально: изначально 
успех: успех 
распечатать: распечатанном 
др: др 
протестировать: протестировать 
похожий: похожие 
количество: количеством количество количества 
выражение: выражениях 
сразу: сразу 
момент: момент моментов 
авторский: авторскую 
продукт: продукта продукте 
принтер: принтере 
оборудование: оборудования 
затрагивать: затрагивающие 
версия: версия версию 
язык: язык языка 
явление: явление 
оставаться: оставаться остается 
просмотр: просмотров 
цена: цена 
попытка: попытки попыток 
образец: образцы 
мало: мало 
вслепую: вслепую 
предыдущий: предыдущая 
пошаговый: пошагово 
обязательно: обязательно 
исследование: исследования 
рассмотреть: рассмотреть 
начинающий: начинающих 
вид: вид видами виде 
помощь: помощи помощью 
действовать: действуют действует 
хакерский: хакерский 
едва: едва 
управление: управлением 
мара: мар 
новый: новой 
сначала: сначала 
эндрю: эндрю 
поместить: помещены 
сбиваться: сбивается 
оранжевый: оранжевым оранжевыми 
пожертвовать: пожертвовать 
сбивать: сбивают 
спасибо: спасибо 
извлекать: извлекает 
тестовый: тестовых 
перезагрузить: перезагрузить 
нетривиальный: нетривиально 
внимание: внимание 
человеческий: человеческого 
применимый: применим 
четырёхслойный: четырёхслойная 
возможно: возможно 
успешно: успешно 
напрямую: напрямую 
каждый: каждой каждое каждые каждая 
общий: общей общая общий 
функция: функция функций 
подробность: подробности 
линия: линиями 
сквозной: сквозные 
задаваться: задаются 
разблокировать: разблокирована 
меню: меню 
считываться: считываются 
ориентироваться: ориентироваться 
подразумевать: подразумевают 
белый: белый 
ггц: ггц 
кремниевый: кремниевого 
год: лет 
точно: точно 
однако: однако 
энергия: энергия 
осуществляться: осуществлялся 
параллельный: параллельного 
переключаться: переключаться 
дзен: дзен 
термин: термин 
нормальный: нормальную 
правильный: правильному 
чип: чип 
сбой: сбой 
прочитать: прочитав прочитать 
больша: больши 
карма: карма 
замкнуть: замкнуть 
затвор: затворам 
наверное: наверное 
последовательность: последовательности последовательность 
необходимо: необходимо 
связь: связи связь 
обмениваться: обмениваться 
протокол: протокола протокол 
ключевой: ключевых 
профиль: профиль 
контакт: контактам контактов контакты 
неисправность: неисправностей 
подтверждать: подтверждает 
маленький: меньше 
согласно: согласно 
протравить: протравил 
возвращать: возвращал 
код: кода кодом код 
б: б 
дать: даст дадим данные дать 
значительно: значительно 
наличие: наличие 
пропуск: пропуску 
сфера: сферы 
программатор: программатора 
снятой: снята 
экономия: экономия 
статический: статического 
запрос: запрос 
поддержка: поддержка 
запитать: запитать 
развёртка: развёртка 
внесение: внесение внесения 
визуально: визуально 
неуместный: неуместной 
загрузка: загрузке 
позволять: позволяет 
исследовательский: исследовательских 
усложнять: усложняет 
узел: узлам 
скрипт: скриптов скрипты 
получаться: получался 
подключать: подключаем 
против: против 
знать: знать 
обратно: обратно 
вплоть: вплоть 
разводка: разводки 
происходить: происходит 
вызвать: вызвать 
тег: теги 
превратить: превратил 
ключ: ключа 
например: например 
м: м 
разный: разные разную разными 
компания: компании компания 
делать: делать 
легко: легко 
статья: статье статьи 
бумажный: бумажными 
таблица: таблица 
случайно: случайно 
около: около 
очень: очень 
небольшой: небольшой небольшую 
младший: младший 
добиваться: добиваются 
отладка: отладки отладке 
получить: получить 
позиция: позиции 
краткий: краткий 
рассматривать: рассматриваемой 
реверс: реверс 
обязать: обязаны 
подтянуть: подтянуть 
подробный: подробнее 
прибор: приборы 
разряд: разрядов 
инженерия: инженерия 
конкретный: конкретной конкретный 
хотя: хотя 
сентябрь: сентябрь 
навигация: навигации 
пирог: пирог 
наложить: наложены 
производитель: производителя 
менее: менее 
обновление: обновление 
декомпиляция: декомпиляции 
цифровой: цифрового цифровым 
задавать: задавать 
секунда: секунд секунду 
создать: созданный 
тип: тип 
средний: средний 
сессия: сессии 
соединять: соединяющие 
помочь: помогла 
удаться: удалось 
запиткать: запитки 
полный: полная полным 
самый: самым 
получать: получает 
сайт: сайт 
бо: бо 
доступ: доступа 
каталог: каталог 
текст: текст 
аппаратный: аппаратной 
веб: веб 
точный: точной точная 
подсказка: подсказки 
книга: книге 
прочее: прочего 
развязывать: развязывающий 
метка: метка 
крупный: крупным 
тестироваться: тестировалась 
связать: связана связано 
начальный: начальных 
последний: последней 
взломать: взломать 
наслать: нашли 
немного: немного 
заглючить: заглючить заглючит 
передавать: передавать передаёт 
технический: техническая 
ма: ма 
воспроизводимость: воспроизводимость 
записываться: записывается 
пока: пока 
найти: найти нашёл 
либо: либо 
проверяться: проверяется 
закладка: закладки 
тайминг: тайминга тайминг 
пора: пор 
большой: велик 
показывать: показывает 
многие: многие 
стараться: стараюсь 
предосторожность: предосторожности 
жк: жк 
смочь: сможем 
активный: активной 
провести: провести 
никакой: никаких никакой 
узнать: узнать узнаем 
прогресс: прогресс 
пройти: пройдёт 
неустранённый: неустранённых 
сообщение: сообщения 
близкий: поближе 
они: ними 
разбить: разбив 
противоположность: противоположность 
блог: блог 
полевой: полевой 
январь: января 
калибровка: калибровку 
отключаться: отключался 
увы: увы 
конечный: конечном 
являться: является 
менять: меняете 
последующий: последующая 
перезагрузка: перезагрузки 
пара: парой пару 
пригодиться: пригодилась 
шифр: шифр 
представлять: представляет 
замысловатый: замысловатую 
судить: судя 
перезапускать: перезапускаем 
сила: силу 
выводить: выводит выводить 
увеличить: увеличить 
перехват: перехват 
эмоциональный: эмоциональных 
держатель: держателе 
добавить: добавить 
дата: даты 
выпустить: выпустит 
формально: формально 
равный: равной 
нужно: нужно 
столбик: столбики 
накопительный: накопительного накопительный 
сигнальный: сигнальных 
сбросить: сброшены 
находиться: находится находились 
идеальный: идеальное 
наводка: наводки 
передача: передачу 
путь: пути 
сводиться: сводилось 
состав: составам 
лишь: лишь 
двусторонний: двустороннего 
вход: вход 
сдвинуть: сдвинуть 
хакинг: хакингу 
немедленно: немедленно 
маркировка: маркировки 
невозможный: невозможен 
сожаление: сожалению 
прерывание: прерывания прерываний 
сделать: сделаны 
означать: означает 
задаться: задались 
длительный: длительной 
хакер: хакер 
мобильный: мобильная 
участок: участками 
фоновый: фоновом 
здание: здания 
увидеть: увидеть 
многий: многих 
начинать: начинать 
замена: замены 
конструкция: конструкцию 
профессиональный: профессиональную 
скорее: скорее 
объект: объектов 
хаба: хабы 
рамка: рамках 
разобрать: разобрать 
управлять: управляющего 
топологический: топологическую 
глубина: глубину 
топология: топологии 
образ: образом 
попробовать: попробовали 
учесть: учтены 
опасение: опасения 
микросхема: микросхемы микросхема 
ещё: ещё 
уйти: уйдёт 
подложка: подложку 
объявление: объявления 
смещение: смещение 
загружать: загружает загружают 
преобразовать: преобразованы 
пояснение: пояснения 
интерфейс: интерфейс 
снова: снова 
достигнуть: достичь 
обычно: обычно 
отдельный: отдельной 
прочтение: прочтение 
временной: временной 
просматривать: просматриваю 
кремнёвый: кремневую 
счастие: счастью 
полезно: полезно 
импульсный: импульсных 
включать: включает 
кроме: кроме 
блокироваться: блокируется 
проверять: проверяет 
подход: подхода 
затем: затем 
неудача: неудачи 
сравнение: сравнению 
меандр: меандр 
вместо: вместо 
указывать: указывает 
точнее: точнее 
препятствие: препятствием 
система: систему 
гистограмма: гистограмма 
процессор: процессора 
большинство: большинство 
верификация: верификации 
резкий: резким 
девайс: девайсы 
выбор: выбор 
обновляться: обновляться 
удачный: удачных 
настроить: настроить 
сосредоточиться: сосредоточиться 
почта: почту 
заявление: заявлений 
документация: документации 
наружное: наружному 
противоположный: противоположна 
хост: хоста 
формулировка: формулировку 
межуровневый: межуровневые 
день: дней 
воздействие: воздействия 
хуан: хуана 
кейс: кейс 
преимущество: преимущества 
заблокировать: заблокирован заблокирована 
площадка: площадок 
говорить: говорят 
фронт: фронт 
влиять: влияют 
правило: правило 
аккумулятор: аккумулятор 
школа: школа 
электромагнитный: электромагнитные 
экземпляр: экземпляра 
быстрый: быстрый 
иной: иной 
составить: составить 
вдвое: вдвое 
пульсация: пульсации 
человек: человек 
красивый: красивым 
хабра: хабр 
подавать: подаём 
первозданный: первозданном 
следующий: следующей 
изучение: изучению 
присутствовать: присутствует 
ось: оси 
льшать: льшая 
задокументировать: задокументированы 
аккуратный: аккуратной 
соответствующий: соответствующих 
звучать: звучит 
отсоединить: отсоединена 
освободиться: освободившееся 
коснуться: коснуться 
идеально: идеально 
снизиться: снизилась 
крутой: крутая 
потеря: потери 
общаться: общаться 
уяснить: уяснил 
выпускать: выпускаемого 
трудно: трудно 
случай: случае 
очевидный: очевидно 
возникать: возникают 
