страна: страны стран 
материал: материалов 
дорожка: дорожках 
общий: общего общем 
день: дня 
пространство: пространство 
планировать: планирует 
го: го 
позволить: позволило 
окружающий: окружающей 
поддерживать: поддерживают 
совет: совета 
гусеница: гусеницы 
являться: является 
бдительность: бдительность 
продажа: продаже продажи 
узел: узла 
турувр: турувр турувра турувре 
себестоимость: себестоимость 
япония: японии 
ожидать: ожидаемой 
один: одного 
яндекс: яндекс 
жан: жан 
город: города городах 
видеокамера: видеокамеры 
успешно: успешно 
будущее: будущем будущее 
солнечный: солнечной солнечные солнечный солнечных солнечная солнечными 
ный: ный 
среднее: среднем 
придорожный: придорожной 
эксперимент: эксперименте эксперимент эксперименты эксперимента 
многослойный: многослойному 
подходить: подходит 
земля: землёй 
транспортный: транспортной транспортного 
повышение: повышения 
собираться: собираемся 
система: система системы 
получать: получать 
способствовать: способствовала 
частый: частого 
комментарий: комментарии 
год: год лет году года 
голос: голосов 
мегаполис: мегаполиса мегаполисе 
непосредственный: непосредственной 
отход: отходов 
прошлое: прошлого 
трактор: трактора тракторов 
количество: количества количество 
меню: меню 
заряжаться: заряжается 
тот: тому 
населить: населённом 
автомобильный: автомобильных автомобильной 
позволять: позволяющей позволяет позволяют 
велосипед: велосипедов велосипеды 
неудачный: неудачны неудачным 
избранник: избранники 
называть: называемой 
выходной: выходную 
судить: судя 
панель: панелей панелях панелями панели 
франция: франции франция 
безопасность: безопасности безопасность 
продавать: продаёт 
установленный: установленным установленные 
высокий: высокая 
нагрузка: нагрузку 
четыре: четырех четыре 
стать: станут 
покрывать: покрывать 
несравнимый: несравнимо 
прибыльный: прибыльным 
ячейка: ячеек ячейки 
такой: такими такие такое 
разбивать: разбивал 
быть: будучи будем будут 
часть: частей 
добавить: добавить 
портить: портили 
электроэнергия: электроэнергии электроэнергией электроэнергию 
девять: девять 
департамент: департамента 
улучшать: улучшающих 
столбик: столбики столбикам 
штука: штук 
энергия: энергия энергией 
иметь: имеют 
энергоэффективный: энергоэффективными 
обеспечение: обеспечения 
снарядить: снаряжённая 
сделать: сделать сделала 
язык: языка язык 
который: которые которая которых который 
поколение: поколением 
дзен: дзен 
возможность: возможность 
дорога: дорогах дороги дорога дорог дороге 
группа: группы группах 
относительно: относительно 
экологически: экологически 
стоимость: стоимость 
годный: годен 
делать: делают делает 
заголовок: заголовками 
поиск: поиск 
зрение: зрения 
обочина: обочине 
тёмный: темное 
использовать: использовать 
прозрачность: прозрачности 
карма: карма 
автомобиль: автомобили автомобилей 
содержать: содержит 
свой: свои 
торн: торн 
совершенно: совершенно 
стандарт: стандартом 
этьен: этьен 
орн: орн 
оптимизация: оптимизации 
сокращение: сокращению 
несколько: несколько 
автономный: автономное автономными автономного автономным 
энергоснабжение: энергоснабжения энергоснабжение 
электровелосипед: электровелосипеды 
загрязнение: загрязнения 
сегодня: сегодня 
настройка: настройка 
тьерри: тьерри 
профиль: профиль 
прочность: прочности 
мэр: мэр 
рост: ростом 
маленький: меньше 
кпд: кпд 
постепенно: постепенно 
квт: квт 
улучшаться: улучшается 
зарядный: зарядной 
технический: технические техническая 
масса: масса массы 
видимость: видимость 
задонатить: задонатить 
специализироваться: специализируется 
занатта: занатта 
переработка: переработки 
старый: старую 
подобный: подобные 
использование: использованию использования использование 
метрополь: метрополь 
сеть: сети сеть 
этот: этому 
мир: мире мира 
раз: раза 
решить: решили 
название: названием 
проезжий: проезжих 
угол: углах 
визуальный: визуальная 
миллион: миллионов 
многий: многих 
предполагаться: предполагалось 
локальный: локальные 
это: это 
минивэн: минивэна 
сми: сми 
бытовой: бытовых 
полимерный: полимерному 
данный: данное данный 
лавик: лавик 
поддержка: поддержка 
установка: установке установка 
пересадка: пересадки 
фокусироваться: фокусироваться 
почему: почему 
вторник: вторник 
освещать: освещает 
первый: первая первый первым 
повышать: повышает 
бракс: браксе бракс 
хаба: хабы хаба 
должный: должен 
рамка: рамках 
различный: различными 
продолжать: продолжать 
комплект: комплектов комплекты 
повысить: повысить 
квадратный: квадратных 
мультимодальный: мультимодального 
получиться: получилось 
сгенерировать: сгенерировать 
автобусный: автобусной 
пешеходный: пешеходного пешеходных пешеходный 
пользователь: пользователь 
пользование: пользования 
журнал: журналу 
ещё: ещё 
освещение: освещения освещение 
велосипедный: велосипедных 
темп: темпах 
проект: проект проекта проекты 
модуль: модули модулях модуля модулей 
чистый: чистая чистым 
территория: территории 
переход: переход перехода переходах 
инновационный: инновационным 
коропорация: коропорации 
пешеход: пешеходов 
правительство: правительства 
автономность: автономность 
течение: течение 
обычно: обычно 
тег: теги 
тулузский: тулузской тулузская 
открыть: открыли 
скрытый: скрытый 
продукт: продукт 
станция: станции 
уровень: уровень 
прочтение: прочтение 
новый: нового 
уменьшить: уменьшить 
благодаря: благодаря 
м: м 
оно: оно 
укладка: укладкой 
пятилетний: пятилетней 
незаметность: незаметность 
энергетический: энергетическую энергетическая 
представительство: представительства 
завершить: завершить 
история: история истории 
компания: компании компания компаний 
мощность: мощность 
углеводород: углеводородов 
центр: центр 
километровый: километрового 
недалеко: недалеко 
остановка: остановки 
вокзал: вокзала 
семейный: семейного 
ночью: ночью 
удачный: удачный 
сша: сша 
электричество: электричества 
вокруг: вокруг 
кроме: кроме 
народный: народные 
источник: источника источник 
вывод: выводы 
промежуток: промежутках 
проводить: проводила 
действительно: действительно 
насколько: насколько 
среда: среде 
шалабра: шалабр 
потребитель: потребители 
деньга: деньги 
пункт: пункте 
настоящий: настоящее 
грузовой: грузовых 
небольшой: небольшие небольших небольшого 
просто: просто 
аккумулировать: аккумулирующей 
работать: работающее работать 
ч: ч 
близость: близости 
питание: питания 
закрывать: закрывают 
ориентация: ориентация 
заказчик: заказчика 
снизить: снизить 
версия: версию 
латта: латте 
сравнение: сравнению 
использоваться: используются 
сутки: суток сутки 
лист: листьями 
предлагать: предлагает 
внедряться: внедряются 
также: также 
англия: англия 
больший: больших 
элемент: элементы 
сократить: сократить 
обеспечивать: обеспечивают 
начало: начале 
заявить: заявил 
виэ: виэ 
электрооборудование: электрооборудование 
независимость: независимости 
подрядчик: подрядчиком 
обмен: обмена 
игра: игра 
подзаряжать: подзаряжать 
шесть: шесть 
объект: объект 
энергонезависимый: энергонезависимым 
улица: улиц 
осветить: освещенных освещены 
точка: точки 
парковка: парковках 
достаточно: достаточно 
последний: последние 
вид: видами 
масштаб: масштаба 
удаться: удалось 
прочный: прочные 
хороший: лучшие лучшую 
оптимизировать: оптимизированному 
произойти: произошло 
прийтись: пришлось 
защитный: защитному 
европа: европе 
сосредоточиться: сосредоточиться 
сайт: сайт 
вырабатывать: вырабатывать 
мишель: мишель 
пестрить: пестрили 
отметить: отметить 
агентство: агентства 
транспорт: транспорта 
мина: мин 
открытие: открытие открытии 
решение: решение решения 
президент: президент 
свеча: свеч 
автомобилист: автомобилистов 
покрыть: покрыт 
французский: французском 
наш: наша 
нынешний: нынешних 
столько: столько 
коммуна: коммуне 
евро: евро 
инновация: инновации 
урбанистика: урбанистики 
водитель: водителей 
горизонталный: горизонталная 
сказать: сказано сказал 
километр: километров 
преимущество: преимущества 
участок: участок участка 
батарея: батареи 
железнодорожный: железнодорожного 
аккумулятор: аккумулятор аккумуляторы 
заявление: заявлении 
тулуза: тулузы 
примерно: примерно 
энергоэффективность: энергоэффективности 
покрытие: покрытию покрытие 
рейтинг: рейтинг 
граница: границ 
составлять: составляет 
другой: другие 
получить: получили 
перш: перш 
направление: направления направление 
спустя: спустя 
весь: всей 
сложно: сложно 
полностью: полностью 
планироваться: планировалось 
отдельно: отдельно 
находиться: находящиеся находящееся 
производство: производства производстве 
возобновлять: возобновляемая 
признать: признала 
исполнительный: исполнительный 
оснащать: оснащают 
закладка: закладки 
изначально: изначально 
простой: простой 
передвижение: передвижения 
энергетика: энергетике энергетика 
поставлять: поставляет 
похожий: похожие 
вернуться: вернуться 
инфраструктура: инфраструктура 
модель: модели 
зона: зонах 
модульность: модульность 
давность: давности 
счёт: счёт 
хабра: хабр 
снижать: снижает 
характеристика: характеристики 
сложность: сложности 
увеличение: увеличения 
обновить: обновить 
вт: вт 
воспользоваться: воспользоваться 
надеяться: надеюсь 
время: время 
выработка: выработке 
электроприбор: электроприборов 
процесс: процессов 
сэкономить: сэкономить 
эффективность: эффективность 
эффективный: эффективные эффективных 
стоить: стоит 
просмотр: просмотров 
хватить: хватило 
публикация: публикации 
устойчивость: устойчивость 
известный: известен 
энергопотребление: энергопотребления 
продвижение: продвижения 
участвовать: участвовали 
потребление: потребления 
развиваться: развиваться 
заметный: заметным 
развёртывание: развертывания 
квартал: квартал 
директор: директор 
экология: экология 
достигнуть: достигнуто 
скорость: скорость 
колесо: колёса 
грязь: грязью 
метр: метров 
известно: известно 
расход: расходы 
прибыль: прибыль 
мара: мар 
декабрь: декабря 
активно: активно 
она: ею 
состоять: состоящих 
