логика: логика логике логики логикой 
мочь: могут можем можете могли могу 
график: графику графиков график графиком 
техника: технику 
конъюнктивный: конъюнктивные 
обходиться: обходиться 
жёсткий: жесткой 
применение: применения применение 
заканчивать: заканчивает 
область: области область областью 
фаза: фазе фазы 
частность: частности 
друг: друга другом друг 
устать: устанешь 
реализовать: реализовал реализованы реализован реализуем реализовать реализующий 
некий: некий 
значение: значение значения значений 
память: памяти память 
занимать: занимать занимали занимает 
микроконтроллер: микроконтроллеров микроконтроллерах микроконтроллера микроконтроллеры микроконтроллер микроконтроллеру 
допущение: допущения 
ваш: вашей вашего 
второе: второе 
хозяйство: хозяйства 
необходимый: необходимые необходимой необходимы 
расчёт: расчеты 
организовать: организовать 
экземпляр: экземпляры экземпляр экземпляров 
выявить: выявленные 
показать: показано показан показанным 
кратное: кратным кратное 
период: период 
битный: битные битная битным битной 
указатель: указатель 
массивно: массивно 
программист: программиста программисты программисту 
часто: часто 
экономить: экономить экономим 
парадигма: парадигму парадигме 
локальный: локальных 
последовательно: последовательно 
критичный: критична 
сам: самой само самого сами 
хранить: хранит 
естественно: естественно 
вызов: вызов вызове 
оперативка: оперативку 
случай: случаях случая случаев случае 
иметь: имеют иметь имеет имели 
смена: смены 
аналогичный: аналогичен аналогичных аналогичный 
обеспечение: обеспечения 
поговорить: поговорим 
различие: различия различие 
требовать: требует 
облегчать: облегчает 
морок: мороки 
возможность: возможность возможности 
мысль: мысли 
регистр: регистров регистром регистре регистрах регистр 
относительно: относительно 
многочлен: многочлена 
компактный: компактные 
использоваться: использовались используется используются использовалось 
программный: программного программной программный программных программные 
передавать: передаем передавали передавать передаю передает 
заменить: заменить заменил 
взгляд: взгляд 
событие: события событие событием событий 
работа: работы работа работу работой работе 
счёт: счетов счета счет 
содержать: содержит 
управление: управления управление 
останавливать: останавливать 
вызвать: вызваны 
имя: имени имена имя 
хотеть: хочешь хочу 
комбинация: комбинация 
несколько: несколько нескольких 
далее: далее 
функциональный: функциональные функциональную функциональный функциональная функциональной 
шаблон: шаблона 
сделать: сделал сделать сделано 
смежный: смежные 
диапазон: диапазоне диапазон 
перекрёсток: перекрестке перекрестка 
ключевой: ключевые 
разобраться: разобрались разобраться 
определять: определяемый определяем определяют 
вполне: вполне 
программа: программу программы программах программе программой программа 
оператор: операторы оператора операторов оператор 
появление: появления 
неструктурированный: неструктурированным 
программирование: программированию программирования программирование программировании 
снижаться: снижается 
остальной: остальная 
базовый: базовые базовый базового 
функционирование: функционирования 
основный: основное 
образ: образ образом 
отличаться: отличаться 
флаг: флаг флага флагу флаги флагами флагов 
допускаться: допускается 
недостаток: недостатки 
предыдущий: предыдущей предыдущий предыдущего предыдущим 
красный: красный красного красном 
выполняться: выполнялись выполняться выполняется 
предназначить: предназначены 
задавать: задающий задающего 
перейти: перейдя 
сидеть: сижу 
формировать: формируют формирует формировать 
демонстрация: демонстрации 
широкий: широкие широкий широкого широкое 
заметить: заметить замечу 
неоспоримый: неоспоримый 
интервал: интервалов интервалам интервалами интервалы интервал интервала 
маша: маши 
команда: команды 
сигнал: сигналов сигнал сигнала сигналы сигналами 
перепутать: перепутать перепутал 
предоставлять: предоставляют 
конечный: конечные конечных конечному конечном конечный 
отличие: отличий отличия 
готовый: готовым готово готовой готовую готовые 
недопустимо: недопустимо 
какой: какое каким какую какие какого 
школа: школах 
особо: особо 
двигатель: двигателями 
почему: почему 
стек: стек 
проанализировать: проанализируем проанализировать 
постараться: постарался постараюсь 
максимум: максимума 
современный: современные современных 
невероятный: невероятную 
система: системах систем системы 
фишка: фишку 
человек: человека 
следующий: следующие следующим следующем 
синтаксис: синтаксис синтаксисом синтаксиса 
помещаться: помещается 
процент: процентов 
продлить: продлить 
внутри: внутри 
приём: прием приемах приемы 
использование: использование использования 
фиксировать: фиксированные фиксированную 
предсказуемый: предсказуемо 
состояние: состояние состояний состояния состоянием 
объявить: объявить объявлена объявлен 
функциональность: функциональности 
бизнес: бизнеса 
подходить: подходили подходит 
панацея: панацеей 
приходиться: приходится приходилось 
связать: связанная связан связаны 
приходить: приходим 
яблоко: яблока 
качество: качестве 
входящий: входящего входящий 
элемент: элемента 
соответствующий: соответствующими 
однопроходная: однопроходных однопроходные однопроходной 
биатлон: биатлона 
выделить: выделить выделим выделено 
переопределить: переопределена 
прерывание: прерываниям прерывание прерываний 
дорогой: дорогого 
опустить: опустить 
ресурс: ресурсов 
угода: угоду 
хороший: хорош лучшим хороший лучшие 
вычислительный: вычислительных вычислительный 
поэтому: поэтому 
производительность: производительности производительность 
сильно: сильно 
формат: формате формат 
отношение: отношением 
состоять: состоять состоит 
получить: полученный полученного 
взаимодействовать: взаимодействует взаимодействуют 
запуск: запуска 
читать: читать 
нужда: нужд 
цикл: цикл цикле цикла циклов 
приятный: приятного 
паскаль: паскалем паскаль 
ввести: введено введем 
разный: разных разные разными 
явно: явно 
пройти: пройти 
передача: передачи передаче 
результат: результата результате результат результаты 
сколько: сколько 
вопрос: вопросе вопросу 
генератор: генератора генератор 
строить: строить строили 
ограничивать: ограничивает 
принимать: принимающая принимает 
решить: решить решил 
круг: круг круга 
один: одному одно одной одном одним 
такой: такого такую такое такие такая таких 
функция: функциям функцию функция функцией функций функции функциях 
два: двум двух 
выполнение: выполнения выполнение выполнении 
прислать: пришли 
наш: наш нашей 
некоторый: некотором некоторые некоторую некоторых 
чтение: чтения 
начинаться: начинается 
объёмный: объемных объемном 
стиль: стиле 
зато: зато 
сложность: сложность сложности сложностью 
начало: начале начала 
переменный: переменную переменной переменных переменные переменная 
пренебречь: пренебречь 
отмечаться: отмечается 
кнопка: кнопкой кнопку кнопки кнопка 
первый: первой первом первого первая первый первым первому 
обмен: обмена обмену обмене 
простить: простите 
вести: ведет 
примитивный: примитивными 
суммироваться: суммировались 
стараться: старались 
точка: точка точки 
диаграмма: диаграммы диаграмма диаграмму диаграмме 
зависеть: зависеть 
заработать: заработала 
дополнить: дополним 
текст: текста тексте текст 
программировать: программировать 
аналогично: аналогично 
трудный: труднее трудный 
логический: логических 
совпадение: совпадении 
младший: младших 
поддержка: поддержку поддержка 
подход: подходы подход подхода 
подобный: подобный подобным подобных 
дать: данному данные дать 
предисловие: предисловие 
вывод: вывода выводы 
связанный: связанных связанны связанные 
минимизировать: минимизирует 
сутки: сутки 
машинный: машинные машинное машинного 
решать: решаем решать 
неблокировать: неблокирующая 
интерфейс: интерфейса интерфейсами интерфейс интерфейсов 
периферийный: периферийное периферийных 
материал: материал 
иначе: иначе 
ваня: вани 
разряд: разрядами 
структура: структурами структур структура структуры структуру структуре 
удобный: удобными 
разрешение: разрешения 
банально: банально 
этот: этих эта этому 
работать: работать работающий 
выполнить: выполнена выполнит выполнить 
быть: будем е будут буду 
коварство: коварство 
постоянно: постоянно 
содержимое: содержимое 
проект: проектом проект 
пропускать: пропускать 
версия: версии версию 
дизъюнктивный: дизъюнктивные 
тело: телах 
повторно: повторно 
ничтожно: ничтожно 
условный: условных 
рейтинг: рейтинг 
позволить: позволят позволит 
короткий: коротких 
параметр: параметра параметр параметры параметрами параметров 
однократно: однократно 
предусмотреть: предусмотрена предусмотреть 
карта: карты 
составление: составления 
сложно: сложно 
метка: метками 
переписываться: переписывались 
считать: считаю считать 
сложение: сложения 
требоваться: требовалось требуются 
составной: составной 
светодиод: светодиоды светодиод 
подключить: подключить 
вернуться: вернуться 
формирование: формирование формирования 
дисциплина: дисциплины 
поле: поля полю полей поле полях 
себя: собой 
смещение: смещением 
математика: математике математики 
ограничить: ограничено ограничен 
годиться: годиться 
потенциально: потенциально 
обновить: обновить 
модель: моделью 
тот: той тому тех 
воспользоваться: воспользоваться воспользуемся воспользуюсь 
привести: приведу 
гореть: горит 
время: время временем времени 
мейнстрим: мейнстримом 
макет: макете 
постигать: постигать 
длительность: длительность 
стоить: стоит 
хватить: хватило 
публикация: публикации 
линейный: линейный линейными линейное линейного линейных линейному линейные линейным 
электронный: электронные 
файл: файл файлы файлов 
так: т 
расширить: расширить 
рисовать: рисовать 
похожий: похож похожие 
умудряться: умудряются 
статья: статьям статья статье статьи 
переключатель: переключатель 
главный: главным 
синхронизация: синхронизации синхронизация 
светофор: светофора светофоре светофорами светофор светофоров светофором 
наоборот: наоборот 
выполнять: выполняли выполняет 
однопроходный: однопроходный 
сдвиговый: сдвиговым 
выглядеть: выглядеть выглядело выглядел 
есть: едят 
основной: основные основной 
управлять: управляющие управляющих управляют управлять управляет 
интересный: интересны интересным 
вывести: вывести вывел 
размещать: размещать 
наглядный: наглядна наглядной 
отвлекаться: отвлекаться 
подходящий: подходящий подходящими 
битый: биты бит 
установка: установки установка 
наука: науки 
обусловить: обусловлена обусловлены 
написать: написано написанной написать напишу написал 
лично: лично 
превышать: превышать превышает 
изменять: изменять 
курс: курсах 
сперва: сперва 
различный: различных различными различного 
архитектура: архитектур 
оставить: оставить оставил 
полезный: полезную полезного 
удобство: удобства 
второй: вторым втором второму второй второго 
вселенский: вселенским 
положительно: положительно 
выбор: выбора 
яндекс: яндекс 
методика: методик 
нагромождение: нагромождения 
попадать: попадает 
знать: знаете 
триггер: триггеру триггера 
комментарий: комментарии комментариях 
аналогия: аналогии 
голос: голосов 
тактовый: тактовая тактов тактовой тактового тактовых 
эквивалентный: эквивалентно 
посмотреть: посмотреть посмотрим 
корректный: корректном 
жёлтый: желтый желтым 
задача: задача задач задачу задачи задачах 
часть: часть частей частью части 
конец: конце конца 
остаток: остатке остатка 
владеть: владеет 
именно: именно 
путаница: путаницы 
порядок: порядок порядке 
включение: включение включением 
формироваться: формироваться 
мышление: мышления 
адрес: адреса 
оба: обе оба обоих обоим 
являться: являются является 
подключение: подключения 
счётчик: счетчик счетчиком счетчика 
номер: номерам номер номера 
граница: границы 
построение: построение построения 
начальный: начальной 
локализовать: локализовать 
проводить: проводили проводить 
итог: итоге итога 
ардуин: ардуино 
цель: целей 
автомат: автомату автоматов автомат автоматы 
учитываться: учитывается 
сводиться: сводятся сводится 
нажатие: нажатии нажатия нажатие 
возможный: возможную 
три: трех 
поиск: поиск поиску 
модифицировать: модифицировать модифицированы 
единый: единой единая 
желать: желаю 
компьютер: компьютеры 
вписать: вписал 
тип: типа тип 
вынести: вынесем 
свой: свои свое своих своей своим 
выразительный: выразительным 
регулятор: регулятор регуляторы 
оптимизация: оптимизации 
равный: равным 
увеличение: увеличение увеличением 
несложный: несложные несложная 
сегодня: сегодня 
настройка: настройка 
следовательно: следовательно 
пол: пол 
мур: мура 
макрос: макросы макрос 
отдельный: отдельный отдельными отдельных отдельную отдельные отдельная 
правильно: правильно 
ошибка: ошибки ошибок ошибку 
далеко: далеко 
прошлый: прошлых 
уравнение: уравнение уравнений 
устройство: устройств устройства 
алгоритмический: алгоритмический 
периферия: периферией 
драйвер: драйвер 
проектировать: проектировать 
упрощаться: упрощается 
алгоритм: алгоритмы алгоритма алгоритмам алгоритме алгоритм алгоритмов алгоритму 
пересылка: пересылки 
использовать: используют использовал использовать 
свойство: свойства 
рассматриваться: рассматриваться 
упрощать: упрощает 
сторона: стороны 
думать: думаю думай 
теория: теорию теории 
это: это 
флажок: флажка 
доставать: достает 
дополнительный: дополнительное дополнительного дополнительную 
нормальный: нормальные нормальная 
накопить: накопленное 
оголиться: оголятся 
номинал: номиналам 
добавить: добавим добавлен добавить 
посвящать: посвящали 
способ: способ 
предпочитать: предпочитаю 
фрагмент: фрагментами 
опасность: опасность 
туториал: туториал 
определить: определить определены определен 
чёрный: черных черного черный 
плата: платы плате 
идея: идеи 
форма: формы форма форму 
задержка: задержки задержка задержек 
мой: мои моим моих 
устанавливать: устанавливать 
становиться: становится 
учить: учили 
ниже: ниже 
обработка: обработка обработку обработкой обработки обработке 
дешёвый: дешевле 
встречаться: встречаются 
оперативный: оперативная оперативной оперативную 
полнофункциональный: полнофункциональный 
искать: ищем ищите 
дальнейший: дальнейшем дальнейшего дальнейшую дальнейшее 
выключить: выключить выключенном 
неподготовленный: неподготовленного 
условие: условий условия условии 
функционировать: функционировать 
ровно: ровно 
целый: целые 
переключение: переключение переключений переключениями переключения 
включаться: включается 
путь: путь пути 
сообщать: сообщает 
данные: данными данных 
составить: составит составим составить 
данный: данном данный 
спойлер: спойлерами спойлером 
расходоваться: расходуется 
который: которых который которое которой которую котором которые которая которого 
действительно: действительно 
структурировать: структурирован 
следом: следом 
просто: просто 
место: место 
загадочный: загадочнее 
состав: состав 
установить: установлен 
учебный: учебном 
лоб: лоб 
причём: причем 
написание: написания 
век: век 
также: также 
своевременно: своевременно 
делать: делает 
проблема: проблемы 
математический: математической математических 
универсальность: универсальности 
получиться: получилась получился 
менять: менять 
плюс: плюс 
мы: нам 
источник: источником 
обратить: обратите обратить 
синтез: синтеза 
мишень: мишень 
библиотека: библиотеки библиотекой 
повторение: повторении 
колледж: колледжах 
достаточно: достаточно 
прямой: прямого 
нарушить: нарушена 
следовать: следует 
простота: простоты 
пид: пид 
превысить: превысит 
байт: байта 
отметить: отметить 
параллельный: параллельной параллельных параллельную 
арифметический: арифметического 
мина: мин 
решение: решение решения 
традиционно: традиционно 
давать: давайте дает 
сравнительно: сравнительно 
суть: сути 
лишний: лишнюю 
должный: должно должна должен 
сравнить: сравните 
крайне: крайне 
эпоха: эпоху 
рационально: рационально 
переключать: переключает 
самый: самое самых 
разместить: разместил разместить 
скобка: скобками 
смещаться: смещается 
эксперимент: эксперименты 
погрешность: погрешность 
убедиться: убедиться 
физический: физическом 
выходной: выходных выходной выходным 
язык: языке язык языка языкам 
разработка: разработка разработки 
разрабатывать: разрабатывали разрабатываемого 
полный: полный 
момент: момента момент моментов 
проверка: проверка проверкой проверку проверки 
пускай: пускай 
выделение: выделение выделением 
указать: указан 
предполагать: предполагает 
рассказывать: рассказывал 
снижать: снижает 
сразу: сразу 
блок: блоков блоком блока блоки блок 
допустить: допустил 
компилятор: компиляторы компилятору компиляторов компилятор компилятора 
деление: деления 
заранее: заранее 
основа: основе 
просмотр: просмотров 
ассемблер: ассемблера ассемблер 
ассемблерный: ассемблерные ассемблерных 
контролировать: контролировать 
ява: яве 
завершение: завершения 
входной: входных входным входное 
мало: мало 
объём: объема объемы объему объем 
предлагать: предлагаю 
обязательно: обязательно 
узнать: узнает 
задумываться: задумывалось 
фактически: фактически 
фактор: факторов 
рассмотреть: рассмотреть рассмотрели рассмотрим 
начинающий: начинающих 
папка: папке 
отклик: отклика 
помощь: помощи помощью 
относиться: относится 
быстро: быстро 
равенство: равенства 
списывать: списывать 
час: часов 
сокращение: сокращение 
провод: проводу 
к: ко 
весь: весь всему всем 
определяться: определяется определяются 
спасибо: спасибо 
контроль: контроль 
влиять: влияет влияют 
предел: пределы предел 
аппаратный: аппаратных аппаратными 
указание: указания 
длинный: длинную 
оптимальный: оптимальное 
внимание: внимание 
особенность: особенность особенности 
синхронизироваться: синхронизируется 
возможно: возможно 
формулировать: формулируем 
консоль: консоли 
привычный: привычном привычного 
напрямую: напрямую 
воспринимать: воспринимать 
вычисление: вычисление 
дискриминант: дискриминанта 
класс: класс классы 
зло: злом 
меню: меню 
преимущество: преимуществом 
концентрация: концентрации 
приводить: приводил 
труд: труда 
размер: размер 
база: базе 
начинать: начинаете 
обращение: обращения обращение 
заморачиваться: заморачиваться 
белый: белый 
защита: защита 
сменяться: сменяется 
обработчик: обработчик обработчикам обработчика 
год: лет годах 
точно: точно 
воздействие: воздействиям воздействие 
видимость: видимости 
кто: кого 
видно: видно 
что: чему 
затратить: затраченное 
реакция: реакции 
никто: никто 
мера: мера 
получаться: получается 
чистый: чистый 
утверждение: утверждений 
дзен: дзен 
информатика: информатике 
попадание: попадание 
заключаться: заключаться 
общий: общие 
термин: термин 
микропроцессорный: микропроцессорную 
причина: причине 
попробовать: попробуйте попробуем 
точность: точность точностью 
единичка: единичка 
карма: карма 
ультракомпактный: ультракомпактные 
адаптация: адаптации 
многое: многое 
калькулятор: калькуляторов 
запись: записью запись записей 
наверное: наверное 
философия: философию 
объявление: объявлении объявление 
генерировать: генерируемого 
крыться: кроются 
последовательность: последовательность последовательностей 
недавно: недавно 
заключение: заключение заключении 
нравиться: нравится 
необходимо: необходимо 
профиль: профиль 
маленький: меньше 
обладать: обладают 
детальный: детальные 
одиночный: одиночный 
ячейка: ячейками 
мигать: мигает 
блокировать: блокирующая блокирует 
код: кода коде кодом код 
стать: стал стало стали 
сеть: сети 
макроопределение: макроопределений 
графика: графика графике 
невозможно: невозможно 
значительно: значительно 
умеренный: умеренной 
схема: схему схемы схем 
заявлять: заявляем 
затруднительно: затруднительно 
соответствовать: соответствующий соответствующее 
ориентировать: ориентированную 
обойтись: обойтись 
таить: таит 
получение: получения получение 
манипулировать: манипулировать 
множественный: множественного 
пример: примеры примера примеру примере 
записываться: записываются 
электрический: электрической 
удовлетворять: удовлетворять 
весьма: весьма 
позволять: позволяет 
описание: описания описанием 
виртуальный: виртуальной 
подряд: подряд 
спрятать: спрятал 
против: против 
продолжение: продолжение 
вне: вне 
фоновый: фоновую 
сборка: сборки 
практика: практике 
магнитофон: магнитофоне 
фон: фоне 
ящик: ящик ящика 
происходить: происходит 
вестись: ведутся ведется 
вероятность: вероятность 
говорить: говорили говорить 
тег: теги 
графический: графических 
однопроходной: однопроходного 
ссылка: ссылке ссылку 
уровень: уровень 
новый: нового новые новых 
компания: компании 
особенно: особенно 
непосредственно: непосредственно 
очень: очень 
зелёный: зеленый зеленого 
операционный: операционных 
паяльник: паяльником 
отладка: отладки 
фигурный: фигурными 
символ: символ 
бывать: бывает бывают 
высокий: высокой 
твой: твоей 
хардкора: хардкора 
приземлить: приземленного 
информировать: информирует 
несомненно: несомненно 
внести: внесло 
народный: народного 
назад: назад 
дискретно: дискретно 
хотя: хотя 
третий: третьей 
понять: понять 
чётко: четко 
автоматический: автоматического 
менее: менее 
дважды: дважды 
корень: корни 
поднятие: поднятием 
поставить: поставленных 
фиксация: фиксация 
совпадать: совпадать совпадает 
опираться: опираясь 
оставаться: остается 
средний: средний 
листинг: листинга листинги 
процесс: процесс процессов 
практически: практически 
ввод: ввода 
осмыслить: осмысленной осмысленные 
мгновенный: мгновенного 
получать: получает 
уверить: уверены 
редко: редко 
стадия: стадии 
опытный: опытные 
потребовать: потребует 
увеличиваться: увеличивается 
кажущийся: кажущейся 
клик: клика 
выходить: выходит 
целочисленный: целочисленного 
дюжий: дюжих 
повседневный: повседневных 
отразиться: отразилось 
планирование: планирования 
учитель: учителя 
рассматривать: рассматривать 
представление: представлении представление 
теряться: терялись 
любить: любят 
пункт: пунктам 
платформа: платформа 
технический: техническая 
полностью: полностью 
немой: нем 
самостоятельно: самостоятельно 
количество: количество количества количестве 
пока: пока 
гайда: гайд 
найти: найти 
оптимизировать: оптимизировать 
периодичность: периодичность 
либо: либо 
тема: тему 
закладка: закладки 
понадобиться: понадобится понадобиться 
пора: пор 
выключение: выключением 
конкретный: конкретного 
возникновение: возникновения 
намерение: намерениях 
многие: многие 
представить: представьте представленной представить 
допустимый: допустимую 
характеристика: характеристики 
долго: долго 
наворотить: навороченных 
идентичный: идентичны идентичен 
указанный: указанную 
писать: писал писать 
небрежный: небрежным 
таймер: таймера 
обращать: обращаю 
однократный: однократный 
способность: способностей 
среднее: среднего 
х: х 
сложный: сложнее сложных 
предпосылка: предпосылки 
объект: объектами 
доступный: доступная 
традиция: традиции 
они: ними 
продолжиться: продолжится 
сопровождаться: сопровождался 
поворот: поворота 
блог: блог 
известно: известно 
объектный: объектно 
очевидный: очевидным очевидно 
вообще: вообще 
видеть: видим 
степень: степени 
удивительно: удивительно 
поддерживать: поддерживают поддерживает 
параллельность: параллельность 
одинаковый: одинаковые 
глубокий: глубокие 
тратить: тратить 
выйти: выйти 
читаемость: читаемости читаемость 
вызывной: вызывным вызывной 
подразумевать: подразумевает 
трудоёмкий: трудоемкий 
рисунок: рисунке 
миля: мили 
назначение: назначение 
метод: методы метод 
простой: простая проще 
пара: парой пару 
текстовый: текстовых 
абстракция: абстракции 
представлять: представляет 
непропорционально: непропорционально 
надёжный: надежнее 
позволение: позволения 
взять: возьмем 
привыкнуть: привыкли привык 
увеличить: увеличить 
раздел: разделе раздела 
ситуация: ситуаций 
порт: портами портов 
заставлять: заставляют 
нужно: нужно 
останавливаться: останавливается 
равно: равно 
вид: виде 
пирог: пироги 
цифровой: цифровых 
хранение: хранения 
резистор: резисторами 
определение: определение определения 
затягивать: затягивать 
зрение: зрения 
выключаться: выключается 
операция: операцией операций 
специальный: специальному специальные специальный 
директива: директивы 
хабра: хабре хабр 
маска: масок 
совершенно: совершенно 
принципиально: принципиально 
институт: институтах 
потенциал: потенциал 
принять: примем 
сожаление: сожалению 
аккуратно: аккуратно 
альтернатива: альтернатива 
выразить: выразить 
колоссальный: колоссальные 
необходимость: необходимостью 
идеальный: идеальном 
мс: мс 
конструкция: конструкции конструкцию 
секунда: секундах 
старый: старую 
строиться: строиться 
раз: раза 
апгрейд: апгрейда 
увидеть: увидеть 
род: рода 
выделять: выделяемого 
ветвление: ветвления 
сброс: сброс 
электроника: электроника 
си: си 
скорее: скорее 
хаба: хабы 
прошивка: прошивки 
разбор: разбор 
целиком: целиком 
пояснение: пояснения 
обрабатывать: обрабатывать 
пятёрка: пятерку 
план: плане 
снова: снова 
бит: биту 
обычно: обычно 
ми: ми 
прочтение: прочтение 
благодаря: благодаря 
передаваться: передается 
рассчитать: рассчитать 
история: история 
инициализатор: инициализаторов 
неоднородный: неоднородным 
полезно: полезно 
глобальный: глобальной 
срабатывание: срабатывания 
каждый: каждого каждом каждый 
сказываться: сказывается 
кроме: кроме 
наступление: наступлении 
вызывать: вызывать 
сформироваться: сформировалась 
проверять: проверяет 
произойти: произойдет произойти 
выбрать: выбран выбрано 
зала: залы 
практический: практические 
затем: затем 
абсолютно: абсолютно 
вместо: вместо 
внешний: внешних 
дань: дань 
погаснуть: погас 
пешеходный: пешеходный 
кофеварка: кофеваркой 
секция: секцию 
применять: применять 
точнее: точнее 
повлиять: повлияет 
большинство: большинство 
кратный: кратно 
истинность: истинности 
минимум: минимума 
настроить: настроить 
читатель: читателя 
вынужденный: вынужденная 
процессор: процессор 
присвоение: присвоения 
забыть: забыл 
жизнь: жизни 
факт: факт 
специализировать: специализированные 
подобрать: подобрана подобрать 
инициализация: инициализации 
другой: другая другие другое другую 
нужный: нужен 
разработчик: разработчиков 
попытка: попыток 
правило: правило 
возобновляться: возобновляется 
настолько: настолько 
здорово: здорово 
будущий: будущую 
микросхема: микросхемах 
тавтология: тавтологию 
понимание: понимания 
погрузиться: погрузиться 
выдавать: выдавали 
бейсик: бейсик 
карно: карно 
безвозвратно: безвозвратно 
ничто: ничем 
осуществлять: осуществлять 
уместно: уместно 
рекомендация: рекомендации 
облачный: облачная 
сожрать: сожрало 
дорогущий: дорогущих 
значит: значит 
десяток: десятков 
вариант: вариант 
однозначный: однозначным 
звучать: звучит 
подсчёт: подсчет 
разбитый: разбиты 
константа: константы 
визуализация: визуализации 
гарантировать: гарантировать 
вспомнить: вспомнить 
вечер: вечерам 
сказать: сказать 
указывать: указываю 
загромождать: загромождать 
вместе: вместе 
контроллер: контроллера 
производиться: производится 
пытаться: пытаться 
