мочь: могут мог могли могла могу 
принимать: принимают принимали принимала 
заказчик: заказчиком заказчику заказчика заказчик заказчиков 
профессиональный: профессионального профессиональными профессиональный профессиональные 
проделать: проделанной 
социальный: социальными социальные социальную социальной социальном социального социальных 
сервис: сервиса сервисами сервис 
обращать: обращают 
постараться: постарайтесь 
презентация: презентацию презентацией презентация презентации 
выступление: выступлений выступления 
решение: решениям решение решения решений 
тонкость: тонкостей 
коллега: коллег коллеги коллегами коллегам коллегу коллега 
выбирать: выбирать 
ваш: вашей ваши ваш вашу ваша 
задумать: задуманного 
организовать: организовать 
четверо: четверо 
инженер: инженеры инженер инженера 
ставить: ставьте 
отбросить: отбросить 
прибыль: прибыли прибыль 
атмосфера: атмосфере атмосферу 
должный: должны 
спецификация: спецификации спецификацию 
потребность: потребность потребности 
фреймворк: фреймворки 
сделать: сделает сделайте сделать сделано 
опрос: опроса опрос опросы 
сбор: сбору сбора 
команда: командой команды команде команду команда командами 
срок: сроки сроков срока срок 
улучшение: улучшению улучшением 
часто: часто 
обвинение: обвинениями 
воспоминание: воспоминания 
личный: личной личных личном личную личные 
рассказывать: рассказывают рассказывать рассказывайте 
полный: полную 
сообщение: сообщение 
очередь: очереди 
публично: публично 
эмоция: эмоции 
пользователь: пользователя пользователь пользователям пользователей пользователю 
ход: ходе 
сократить: сократит сократила 
ожидать: ожидает 
поговорить: поговорим поговорить 
шаг: шаг 
переходить: переходят 
фасилитатор: фасилитаторов 
вопрос: вопросам вопросы вопроса вопросе вопросах вопрос 
прикол: приколы 
подведение: подведение 
группа: группы группами 
период: периода 
помешать: помешала 
словно: словно 
парный: парные 
реализация: реализации реализацию 
взгляд: взгляд 
наладить: наладить 
работа: работы работа работу работе 
большой: большом большое большой 
посиделки: посиделках 
неделя: неделю недели 
нахождение: нахождения 
доверительный: доверительные 
несколько: несколько несколькими 
далее: далее 
потеря: потерям 
разобрать: разобрали разберем 
участник: участникам участники участник 
проблема: проблема проблем проблемами проблемах проблемы проблемой проблему 
барьер: барьеров барьер 
задача: задачам задаче задача задач задачу задачами задачи 
ключевой: ключевые 
поделиться: поделюсь 
стать: статей станет стал стать 
дисклеймера: дисклеймер 
линия: линия линией 
оценка: оценку оценке 
конечный: конечного конечном конечный конечную 
потратить: потратили потратил 
постепенно: постепенно 
дружить: дружить 
технический: технические техническим технический техническая технических 
важный: важны важен 
просить: просит 
учиться: учитесь 
мероприятие: мероприятиях 
решить: решили решил 
итерация: итерации 
непросто: непросто 
молчать: молчат молчите 
разговаривать: разговаривает разговаривать 
предложить: предложить 
вслух: вслух 
заметить: заметить 
мессенджер: мессенджере мессенджера 
попасть: попасть 
рубрика: рубрика 
незнание: незнанием 
наш: нашу наш наших нашими нашего нашей 
проект: проекту проектом проекте проекта проектами проектов проектах проект 
баг: багом багов баги 
играть: играют 
поток: потока 
поддерживать: поддерживали 
знание: знаний 
почему: почему 
стек: стек 
уровень: уровнях уровне уровни 
доработка: доработки 
звать: зовут 
внутри: внутри 
приём: прием приемов приемы 
год: года лет годом год 
формироваться: формируются 
гордиться: гордиться 
состояние: состояние 
сотрудник: сотрудники сотрудников сотруднику сотрудникам сотрудниками сотрудника сотрудник 
участвовать: участвует участвуйте 
доска: доски доске доску 
собирать: собирать 
чёткий: четкую четкой 
смотреть: смотрел смотреть 
уйти: уйти ушло 
изучить: изучить изучите 
среди: среди 
хотеть: хотим хотят хотел хочет хотели хотите 
выделить: выделить 
медиана: медиану медиана 
продукт: продукт продуктом продукта продукте 
счёт: счете 
прежде: прежде 
поэтому: поэтому 
визуализация: визуализация 
достигнутый: достигнутой 
коммуникация: коммуникации коммуникаций 
формат: формате формат 
вовсе: вовсе 
оформление: оформление 
случиться: случиться 
неудобно: неудобно 
читать: читать 
понять: поймите понять 
показывать: показывайте показывать 
разный: разных разным разные разными 
дублировать: дублирует 
польза: пользу 
передача: передачи 
насколько: насколько 
вовлечь: вовлечь вовлечены вовлечена 
результат: результата результат результаты результатами 
групповой: групповых 
март: марте 
один: одному одной одну одном одна одни 
тестирование: тестирования тестирование тестированием 
обратный: обратную обратной обратная 
неформальный: неформального неформальные 
прислать: пришли 
этап: этапы этапом 
точка: точек точки точку 
ответ: ответов ответ ответа 
месяц: месяцев 
контур: контурах 
путать: путать 
молодой: молодые 
существо: существом 
какой: каким какими какие 
репутационный: репутационным 
нерабочий: нерабочие 
уникальный: уникальный 
начало: начале начало 
зря: зря 
уточнить: уточнить 
стремиться: стремились 
обмен: обмена 
голос: голос голосов голоса 
анонимный: анонимного анонимные анонимный 
оформлять: оформляйте 
значимый: значимым 
кот: котов 
сообщество: сообщество 
стараться: старались стараемся старайтесь 
клиент: клиентов клиенты 
внутрикомандный: внутрикомандные внутрикомандных 
ретровстреча: ретровстречу 
сотрудничество: сотрудничество 
вчера: вчера 
мифический: мифическим 
они: ими ними 
рукав: рукава 
оценивать: оценивает 
следующий: следующем 
укрепить: укрепив укрепить 
класс: классов класс классам 
говорить: говорит говорите говорить говорят 
риск: риск 
достижение: достижения достижение 
такой: таким такую такое такие таком таких 
сутки: сутки 
профессионал: профессионалами 
случайный: случайным 
решать: решаем решает решают решать 
сложный: сложные сложном сложными сложнее 
уточнять: уточняя 
продолжать: продолжайте 
брать: берите берет 
уважение: уважением 
этот: этих эта этому 
скилла: скиллы 
работать: работать работают работал работает 
неверный: неверный 
вертикальный: вертикальной 
январь: январе 
знак: знаком 
событие: событие 
двигать: двигают 
конфликт: конфликты 
отличный: отличные отличная 
сам: сама сами 
рейтинг: рейтинг 
вес: вес 
затягиваться: затягивались 
спустя: спустя 
сложно: сложно 
способ: способом способ способы способах 
продолжаться: продолжается 
прийти: пришел 
заниматься: занимаются занимайтесь 
разработчик: разработчиками разработчика разработчик разработчики разработчиков 
прозрачный: прозрачными 
пропустить: пропустить 
вернуться: вернуться 
помочь: помогут помогите поможет помогла помочь 
возможный: возможных 
сложность: сложности сложностях 
комбинировать: комбинируйте 
забыть: забыть забудьте забыв 
флоу: флоу 
слышать: слышали 
обновить: обновить 
обсуждать: обсуждать обсуждали 
свой: своими свой свои своих своей своим 
время: время временем времени 
персонал: персоналом 
чат: чаты 
совместный: совместные 
стоить: стоит 
публикация: публикации 
испытывать: испытывает 
рисовать: рисовать 
речь: речи 
компания: компанией компаниях компании 
высказывание: высказывания 
общение: общение общением общения 
тесный: тесен 
тимбилдинг: тимбилдинги тимбилдинг тимбилдингах 
семейный: семейном 
текущий: текущем текущим 
предназначение: предназначение 
скорость: скорость скорости 
дизайн: дизайна 
влияние: влияния влияние 
дополнительный: дополнительный дополнительного 
задеть: задело 
основной: основные 
описать: описать опишите 
регулярный: регулярных регулярные регулярная 
написать: написано написать 
лично: лично 
управление: управление 
различный: различных 
промежуточный: промежуточных 
считаться: считается 
площадка: площадки 
некоторый: некоторым некоторые 
срочно: срочно 
давно: давно 
база: базы 
яндекс: яндекс 
вечерний: вечерних 
нужный: нужны нужным 
руководство: руководством 
очевидный: очевидными очевидна очевидную очевидные 
подсветить: подсветила подсветить 
рассказать: рассказать расскажите расскажу рассказали 
разработка: разработкой разработки 
царить: царят 
подходить: подходит 
итог: итоги итоге итогов 
комментарий: комментарии 
аналитик: аналитики 
микросервис: микросервисы 
проверять: проверяй проверяли проверяет 
визитный: визитная 
приоритезировать: приоритезируйте 
грановеттер: грановеттера 
пользовательский: пользовательских пользовательские 
именно: именно 
понимать: понимаете понимаешь понимает понимала понимать 
начать: начать начните 
орфография: орфографии 
сократиться: сократилась 
причина: причинам 
передавать: передающие 
тестовый: тестовом 
мотивация: мотивацию мотивации 
встреча: встреч встречи встреча встречам встречах встречу 
присылать: присылает 
взаимодействие: взаимодействии взаимодействия 
развитие: развитии развития развитие развитию 
жизнь: жизнь жизнью жизни 
ранний: раньше 
записывать: записывайте 
скорректировать: скорректированный 
знакомство: знакомства знакомство 
крылатый: крылатые крылатыми 
приёмочный: приемочных 
внутренний: внутренние внутренних 
тост: тост 
цель: целей цель цели 
отвечать: отвечающими отвечает отвечали отвечать 
приходить: приходят 
дефект: дефектов 
устраивать: устраивают устраивает 
поиск: поиск поиску 
тот: те тому 
классный: классных 
гипотеза: гипотез 
новый: новом нового новый новые новых 
приниматься: принимаются 
популярный: популярной 
простой: простыми проще простой 
архитектура: архитектуры архитектура архитектуру 
ждать: ждать 
орган: органов 
увеличение: увеличение 
старший: старший 
сегодня: сегодня 
который: которым которых который которой которую котором которые которая которого 
настройка: настройка 
место: места местах 
стикер: стикеры стикер 
ответственность: ответственности ответственность 
два: двумя двух две 
пожаловаться: пожаловались 
человек: людям людьми люди человек 
правильно: правильно 
сближаться: сближаются 
ошибка: ошибки ошибок 
плохо: плохо 
привести: приведите привело приведет 
иной: иные 
сторона: стороне стороны сторона 
драматический: драматическим 
выстраивать: выстраивать 
объективный: объективным 
дейлик: дейлики 
связь: связей связи связь связях 
лаконично: лаконично 
приоритизировать: приоритизировать 
теория: теорию 
обсуждение: обсуждением 
это: это этим 
первый: первого первое первая первый 
иметь: имеет 
рекомендация: рекомендацию 
использование: использования 
продя: проде 
делать: делаем делает делать делаете 
маркетинговый: маркетинговые 
функционал: функционал функционала 
мем: мемы 
хороший: лучший лучшие хороши хорошие 
менеджер: менеджере 
повышать: повышает 
автотест: автотестам 
доверять: доверяй 
повысить: повысить повысит 
лист: листа 
регулярно: регулярно 
организм: организма 
создать: создайте создать создали 
понимание: понимание 
отношение: отношений отношение отношениями отношения 
эффективный: эффективными эффективную 
графика: графики 
банк: банка банке 
поставка: поставки 
треугольник: треугольником треугольника треугольник 
конкретный: конкретных конкретной конкретного конкретные 
укреплять: укреплять 
собрать: соберите 
каждый: каждым каждой каждый 
резкий: резких 
знать: знает знаем 
испортить: испорчено 
переписывать: переписываем 
сигнал: сигналы 
остаться: останется 
форма: форме 
дальнейший: дальнейшем 
софт: софт 
упорный: упорного 
расширение: расширение 
пройти: прошло пройдет пройдены прошла 
решиться: решилась 
общественный: общественных 
статья: статья статье 
рабочий: рабочую рабочего рабочие рабочей 
быть: будь будут суть будьте 
интеграция: интеграций 
вовремя: вовремя 
приводить: приводит 
онлайн: онлайн 
действительно: действительно 
день: день дней 
активность: активностях активности активностей 
спросить: спросите спросить 
демотивация: демотивацию 
выполнить: выполнено 
основополагающий: основополагающий 
просто: просто 
напоминание: напоминания 
лояльность: лояльность 
зависать: зависают 
кто: кому 
замалчивать: замалчивают 
быстрый: быстрее быстрая быстрый 
написание: написания 
ожидание: ожиданиям 
индивидуалист: индивидуалистов 
пользоваться: пользоваться 
человеческий: человеческий 
отдел: отдела 
также: также 
обозначить: обозначили 
педантичность: педантичность 
мы: нам 
выгодно: выгодно 
чувство: чувство 
потерять: потерял 
тинькофф: тинькофф 
комментировать: комментировать 
параметр: параметры 
достаточно: достаточно 
дело: дела дело дел делами 
лежать: лежит 
вещь: вещь вещи 
элементарный: элементарным 
упомянуть: упомяните 
нарушение: нарушение 
игровой: игровой 
бот: бот бота 
ухудшить: ухудшить 
сильный: сильных сильного 
верхнеуровневый: верхнеуровневом 
чувствовать: чувствовать 
сценарий: сценарий 
мина: мин 
подсвечивать: подсвечивает подсвечивайте 
показать: покажет показал покажите 
уволиться: уволился 
смочь: сможете сможет 
межличностный: межличностные 
ослабевать: ослабевают 
продовой: продовом 
убедиться: убедиться убедитесь 
помогать: помогает помогают 
язык: языке язык языка языках 
установить: установить 
пропускать: пропускаемых пропускайте 
полнота: полноты 
информация: информации 
тимлида: тимлид тимлиде тимлидам 
вводить: вводя 
обеспечиваться: обеспечивается 
забота: забота 
весь: всей всем 
возникать: возникала возникают 
остальной: остальные 
митапа: митапы 
ретроспектива: ретроспектива ретроспективы 
проверка: проверка проверки 
стадия: стадиях 
опыт: опытом 
похожий: похожие 
проходить: проходит 
доход: доход 
проверить: проверить 
определённый: определенный 
заранее: заранее 
канбан: канбан 
просмотр: просмотров 
статус: статусе статусах статус 
обесцениваться: обесценивались 
узкий: узкие узких 
потрешить: потрешить 
схема: схемами 
мало: мало 
выявление: выявления 
предлагать: предлагаю предлагать 
сфокусироваться: сфокусируйтесь 
открыто: открыто 
дейли: дейли 
тратиться: тратилось 
исследование: исследования 
банковский: банковских банковском 
спор: споры 
вид: вид 
апрель: апреле 
ясный: ясны 
изучение: изучением 
быстро: быстро 
час: часов 
рисунок: рисунки 
сначала: сначала 
фича: фичи 
оказаться: оказаться 
забывать: забывайте забывая 
измеримый: измеримые 
готовность: готовности 
дух: духе 
влиять: влияет влияют 
встречать: встречали 
подводиться: подводиться 
исследовательский: исследовательское 
взаимоотношение: взаимоотношения взаимоотношениях 
придерживаться: придерживайтесь 
внимание: внимание 
мой: моей 
озвучить: озвучить озвучу 
напрямую: напрямую 
создавать: создавало 
приятный: приятнее 
анализ: анализа анализ анализу 
система: система системы систему 
нужда: нужды 
значение: значения 
озвучивать: озвучивают 
терпеливо: терпеливо 
выдёргивать: выдергивать 
тема: темы тема 
меню: меню 
помимо: помимо 
обеспечивать: обеспечивать 
включая: включая 
составлять: составляющая 
труд: труда 
упрощение: упрощение 
чистый: чистого 
дойти: дойдет 
полдеть: полдела 
перестать: перестали 
частый: чаще 
помощь: помощью помощь 
ценность: ценностей 
слабый: слабых 
качественный: качественный 
пара: пары 
никто: никто 
другой: другими других другие 
получаться: получается 
обращаться: обращалась 
принятие: принятия 
структура: структуры структуру 
дзен: дзен 
друг: другом друг 
пропасть: пропадут 
прод: прод 
признак: признакам признаку 
максимум: максимуму 
общий: общие общий 
увеличивать: увеличивая увеличивают 
подводить: подводите 
бэклога: бэклог 
целый: целый 
использовать: использовать используйте используемые использует используем 
попробовать: попробуйте 
яркий: яркие 
непродуктивный: непродуктивно 
карма: карма 
укрепление: укреплению укрепления 
означать: означают 
риска: рисках 
выражение: выражениями 
недавно: недавно 
заключение: заключение 
нравиться: нравится 
активация: активации 
профиль: профиль 
карточка: карточка 
показаться: показаться 
отрицательный: отрицательные 
качество: качества качество 
продакт: продакт 
б: б 
ссора: ссоры 
потребитель: потребителя потребитель 
стесняться: стесняются стесняется стесняйтесь 
задуматься: задуматься 
май: мае 
провести: провели провести 
убедить: убедить 
понятно: понятно 
запрос: запрос 
следить: следите 
поддержка: поддержка поддержки 
аудитория: аудиторию 
значимость: значимости 
дать: дала дать 
угодный: угодно 
выявить: выявить выявите 
пример: примеры пример 
обладать: обладать 
спокойный: спокойную 
мотивировать: мотивируйте 
проводить: проводить проводите проводим проводят проводил 
стандартный: стандартных 
точечный: точечные 
против: против 
специалист: специалистов 
обратно: обратно 
свободный: свободным свободном 
предыдущий: предыдущего 
практика: практике практика практик 
происходить: происходит 
иностранный: иностранного 
взглянуть: взглянуть 
вызвать: вызвать 
тег: теги 
представлять: представляете 
научиться: научились 
взаимный: взаимными 
вникать: вникать 
например: например 
разговор: разговоре 
предпочитать: предпочитают 
созвон: созвоны 
стратегия: стратегии 
буферный: буферных 
около: около 
отнестись: отнестись 
бывать: бывает бывают 
получить: получить 
приоритетный: приоритетные 
громкий: громче 
настроение: настроение 
грамотный: грамотной 
придать: придав 
ситуация: ситуации 
фиксировать: фиксируйте 
скопиться: скопился 
сила: силы 
обратить: обратить 
считать: считаешь 
исполнитель: исполнителем 
смешной: смешной 
исключение: исключение 
спрашивать: спрашивал спрашивайте спрашивать 
поставить: поставленных 
наиболее: наиболее 
национальный: национальные 
мозг: мозг мозгу 
восстановить: восстановить 
задавать: задавать 
хотеться: хочется 
ограничиться: ограничилось 
бизнес: бизнес 
опираться: опираясь 
конкурс: конкурс конкурсы 
психологический: психологический 
процесс: процесс процессов процессах процесса 
инструмент: инструменты инструментов 
удаться: удалось 
дополнение: дополнение 
сайт: сайт 
слушать: слушали 
текст: текст 
делить: делить 
сопереживание: сопереживания 
офлайн: офлайн 
давать: дает дают 
доставка: доставки 
вектор: вектор 
обмениваться: обмениваетесь обмениваются 
клиентский: клиентской 
изменение: изменения 
разборка: разборок 
больший: большей 
планирование: планирования планирование 
данные: данных 
наслать: нашли 
полностью: полностью 
вина: вине 
немой: нем 
количество: количество количестве 
пока: пока 
найти: найти 
либо: либо 
вариант: вариантов варианты 
требовать: требовать 
гораздо: гораздо 
пирамида: пирамиде 
согласование: согласования 
закладка: закладки 
ответить: ответьте 
слово: слово слова словами 
вестись: велось 
представить: представьте 
релиз: релиза 
аутсорс: аутсорс 
профессия: профессии 
открытый: открытые 
сталкиваться: сталкиваются сталкивается 
проектный: проектным 
разобраться: разобраться 
презентовать: презентовать 
приносить: приносят 
немало: немало 
никакой: никаких 
узнать: узнать узнаем 
план: план 
х: х 
николай: николай 
настроить: настроили 
отличие: отличие 
термин: терминов 
о: обо 
квартал: квартал 
выполнять: выполняемых 
самый: самые самый 
блог: блог 
создание: создания 
прибегать: прибегаем 
исчезнуть: исчезла 
тест: тест 
особенность: особенности 
столь: столь 
подкаст: подкаста 
степень: степени 
меняться: меняющихся 
карьера: карьеры 
действие: действия 
фраза: фраз 
подразумевать: подразумевает 
заведение: заведения 
технология: технологий 
метод: методы 
представление: представления 
полезный: полезен 
определять: определяют 
случай: случай случае 
реальный: реальные реальной реальным 
камера: камеру 
испытание: испытаний 
сформировать: сформирована 
воспринимать: воспринимает 
критерий: критериев 
далёкий: далеким 
общаться: общались общаться общаются 
должное: должное 
кейс: кейсы 
добавить: добавить 
концепция: концепцию 
карпмана: карпмана 
нужно: нужно 
зависнуть: зависнуть 
выяснить: выясните 
равно: равно 
подход: подход 
скрытый: скрытые 
думать: думают 
сообща: сообща 
дизайнер: дизайнер дизайнеру 
ответственный: ответственному 
момент: моменты 
командный: командных 
боль: болях 
завтрак: завтраки 
непонятный: непонятные 
зрение: зрения 
путь: пути 
существовать: существует 
лишь: лишь 
член: член 
корн: корне 
лишний: лишний 
вспоминать: вспоминает 
промежуток: промежуток 
трудность: трудности 
вершина: вершина 
делиться: делиться делитесь 
небольшой: небольшую 
регламент: регламент 
доходить: доходил 
ставиться: ставятся 
включать: включать 
вовлекать: вовлекайте 
ускорение: ускорение 
короткий: короткие 
попросту: попросту 
напомнить: напомнить 
старый: старую 
раз: раза 
увидеть: увидеть 
методология: методологии 
многий: многих 
повод: повод поводом 
установленный: установленные 
нервный: нервные 
непростой: непростом 
готовиться: готовьтесь 
хаба: хабы 
нарушить: нарушены 
рамка: рамках 
реализовать: реализовали реализованных 
образ: образом 
покрытие: покрытия 
оказать: окажет 
приёмка: приемки 
повседневный: повседневной 
показатель: показатели 
взаимосвязь: взаимосвязи 
осознавать: осознавать 
отлично: отлично 
течение: течение 
достигнуть: достичь 
обычно: обычно 
цикл: цикла 
неочевидный: неочевидным 
прочтение: прочтение 
благодаря: благодаря 
целевой: целевую 
выпуск: выпусков 
роутинг: роутинга 
начинать: начинаешь 
улучшиться: улучшились 
вызывать: вызывать 
отслеживание: отслеживания 
профессионализм: профессионализм 
важно: важно 
наличие: наличии 
снизить: снизить 
версия: версию 
внешний: внешних 
вырасти: выросла 
соответствовать: соответствовать 
метрика: метрик 
применять: применять 
точнее: точнее 
уделять: уделяет 
разделение: разделении 
узнавать: узнают 
грамотно: грамотно 
иметься: имеющихся 
низкоуровневый: низкоуровневые 
право: право 
интересный: интересна 
заполнить: заполнить 
шесть: шесть 
праздник: празднике 
взять: взяли 
выбор: выбор 
совет: советами 
визуализировать: визуализируйте 
лёгкий: легче 
контактировать: контактировать 
почта: почту 
разбитый: разбитом 
служба: службы 
строго: строго 
воронка: воронка 
положительный: положительные 
профессионально: профессионально 
относиться: относитесь 
мир: мир 
спринт: спринтом 
полгода: полгода 
таск: таск 
запоминать: запоминайте 
стабильно: стабильно 
важность: важности 
сказать: скажу 
развивать: развивайте 
условие: условиях 
синхронизация: синхронизация 
сказываться: сказываться 
зарабатываться: зарабатывается 
безвозвратно: безвозвратно 
приятно: приятно 
обсудить: обсудить 
волокно: волокна 
глупый: глупым 
впечатление: впечатление 
привлечение: привлечения 
смысл: смысл 
порядок: порядке 
понятный: понятны понятными 
хабра: хабр 
производительность: производительность 
любой: любой 
выступать: выступать 
активизироваться: активизировались 
основа: основы 
полнотелый: полнотело 
вникнуть: вникнуть 
значит: значит 
писать: писать 
авторитет: авторитетом авторитет 
появляться: появляются 
незнакомый: незнакомое незнакомые 
груминг: груминг 
книга: книг 
поднимать: поднимают 
повлиять: повлияли 
вспомнить: вспомнить 
отсчёт: отсчета 
блок: блок 
ухудшение: ухудшению 
ретро: ретро 
жизненный: жизненного 
доклад: докладов 
объяснить: объясните 
ит: ит 
ежедневный: ежедневные 
вместе: вместе 
