мочь: могут 
постоянно: постоянно 
скрипт: скрипта скрипт 
управление: управление 
проверка: проверки проверка 
многое: многом 
задача: задачи 
компилятор: компилятора компиляторы 
поле: полей поля 
запускать: запускают запускать 
обращаться: обращайтесь 
правило: правило 
профиль: профиль 
запуск: запуска запуск запуске 
различный: различных 
данные: данных 
однозначный: однозначного 
параллельный: параллельных 
бояться: боюсь 
неправильный: неправильного 
просмотр: просмотре просмотров 
версия: версии версию 
понять: поняли 
помочь: помочь 
ошибка: ошибки ошибок 
простой: простые простой 
перевод: перевода 
логика: логики 
добавить: добавлены добавить 
некачественный: некачественного 
часть: частью 
информация: информацией 
использовать: используете используют используемого 
неправильно: неправильно 
рейтинг: рейтинг 
донести: донести 
который: которых которой которые 
программа: программами программа программы программах программ 
корректный: корректен 
выбрать: выбрать выбран 
анализатор: анализатор анализаторы анализатора 
разработка: разработки 
результат: результата 
яндекс: яндекс 
больший: большую большей 
официальный: официальной 
статический: статический статических статического статические 
покрытие: покрытие 
весь: всей 
свой: своей своем 
технический: техническая 
хороший: лучшего лучшие 
начинать: начиная 
возможно: возможно 
память: памяти 
язык: языков язык языка языкам 
исходный: исходном 
код: кода код коде 
указать: указать 
решать: решаемые 
старый: старую 
программирование: программирования 
количество: количество количеством 
недостаток: недостатки 
пока: пока 
найти: найти 
анализ: анализа анализ 
получать: получают 
разработчик: разработчикам разработчик 
проверять: проверяют 
комментарий: комментарии 
диагностика: диагностике 
важно: важно 
выполнение: выполнения 
находить: находят находить 
голос: голосов 
спонсор: спонсоров 
закладка: закладки 
синтаксический: синтаксических 
выявление: выявление выявления 
последний: последним 
заканчивать: заканчивая 
большой: велик 
меню: меню 
планета: планеты 
уровень: уровни уровень 
писать: пишут 
похожий: похожие 
вернуться: вернуться 
это: это 
инструмент: инструмента инструменты 
далее: д 
уйма: уйму 
метрика: метрик 
параметр: параметрах 
сторона: сторону 
подозрительный: подозрительных 
смысл: смысл 
программист: программист 
завтра: завтра 
хабра: хабр 
реальный: реального 
использование: использования использование 
полный: полное 
работа: работа работы 
сложность: сложности 
проведение: проведении 
сразу: сразу 
вакансия: вакансий вакансия вакансии 
поиск: поиске поиск 
оставить: оставил 
существовать: существуют 
получить: получил 
негрей: негрей 
поддержка: поддержка 
прикладывать: прикладывает 
рекомендация: рекомендации 
конструкция: конструкций 
страница: страницам 
компилировать: компилируемым 
слышать: слышали 
дело: деле дело 
обновить: обновить 
си: си 
пример: примеры примеров пример 
файл: файла файл 
быть: е 
необходимость: необходимость 
фрагмент: фрагменты 
популярность: популярность 
оформление: оформлению 
мёртвый: мертвый 
общий: общую 
утечка: утечек 
время: время 
история: истории 
ориентироваться: ориентируется 
ответ: ответа 
впереди: впереди 
год: лет 
недочёт: недочетов 
позволять: позволяет 
хаба: хабы 
зависеть: зависит 
значит: значит 
сам: самом 
панацея: панацея 
усечь: усеченные 
опечатка: опечатки опечаток опечатками 
сообщество: сообщество сообществе 
цель: цель 
установка: установка 
выполняться: выполняться 
публикация: публикации 
проявить: проявить 
достаточно: достаточно 
процесс: процесс 
так: т 
образ: образом 
обеспечение: обеспечения 
данный: данный 
выбор: выбор 
приравнивать: приравнивает 
усилие: усилия 
самый: самым 
тип: типы 
связать: связано 
подсчёт: подсчет 
скрытый: скрытые 
пользователь: пользователь 
список: список 
дзен: дзен 
автоматизация: автоматизация 
умолчание: умолчанию 
редко: редко 
оф: оф 
ветка: ветку 
сосредоточиться: сосредоточиться 
сайт: сайт 
вынести: вынести 
проблема: проблем 
возвращать: возвращаемого 
значительный: значительные 
развитие: развития 
вопрос: вопрос 
массив: массива 
скомпилировать: скомпилированная 
место: местах 
документация: документации 
мина: мин 
производить: производимый 
такой: такое 
тот: те 
приближать: приближает 
обнаруживать: обнаруживать 
программный: программного 
описать: опишу 
операться: операются 
статья: статьи статье 
следующий: следующим 
реализация: реализации 
опция: опции 
тег: теги 
попадание: попадания 
среда: среды 
карма: карма 
сутки: сутки 
крайне: крайне 
ниже: ниже 
компания: компания 
функция: функцией 
есть: едят 
п: п 
развиваться: развиваются 
быстро: быстро 
проект: проекта 
прочтение: прочтение 
класс: класса 
например: например 
совершенно: совершенно 
исследовать: исследуемых 
несколько: несколько 
мара: мар 
конфигурация: конфигурации 
допустить: допустить 
предупреждать: предупреждает 
легко: легко 
пасть: пал 
последствие: последствия 
сергей: сергей 
сегодня: сегодня 
настройка: настройка 
слабый: слаб 
подробный: подробной 
преимущество: преимущества 
