весь: весь 
порт: порт порта 
различный: различных различные различными 
большой: большой 
кардинально: кардинально 
извлекать: извлекает 
поток: потоков 
являться: является 
попытка: попытка 
унифицировать: унифицированной 
портировать: портировал 
один: одного одному 
яндекс: яндекс 
обработка: обработки обработка 
ошибка: ошибку ошибки ошибка 
нетерпение: нетерпением 
значение: значение значений значением 
красиво: красиво 
возможно: возможно 
успешно: успешно 
будущее: будущем 
некоторый: некоторое некоторые 
указывать: указывать 
вычисление: вычисление 
функция: функция функции функцию 
представление: представления 
игнорировать: игнорировать 
комментарий: комментарии комментариях комментариев 
класс: класс класса классом классов 
голос: голосов 
сторона: стороной сторону 
случай: случай случае 
меню: меню 
посмотреть: посмотреть 
стиль: стиль стиле 
автор: автор 
особенность: особенностью 
взять: возьмем взять взятые 
строковый: строкового 
задача: задача 
репозиторий: репозитории 
часть: часть 
программист: программист 
любой: любое 
описать: описан 
дать: данная данной 
крен: крен 
функциональный: функциональном функционального функциональное функциональных функциональная функциональным 
сопоставление: сопоставлении сопоставления сопоставление 
исключение: исключений исключениями исключение исключением 
вид: виду 
такой: такими таким таких 
библиотека: библиотеке библиотеки библиотека 
начинать: начинает 
добавить: добавить 
строка: строки 
метод: метода 
делаться: делается 
однако: однако 
типичный: типичный 
число: числе 
частый: чаще 
инициализировать: инициализирует 
запечатать: запечатанных запечатанным запечатанного запечатанный 
помощь: помощью помощи 
рассмотреть: рассмотрим 
нужно: нужно 
приём: приемами прием 
интересно: интересно 
находиться: находятся находится 
иметь: имеют иметь 
пожалуйста: пожалуйста 
уважаемый: уважаемые 
финализировать: финализировано финализированы финализирована 
знакомый: знакомая знакомый 
язык: языка языках языки языком языке языков язык 
идея: идея 
ждать: жду 
сделать: сделав 
дзен: дзен 
возможность: возможность возможности 
результат: результатом результат результатов результата 
заметить: заметим 
версия: версией версию версии 
четыре: четыре 
смоделировать: смоделируем 
поиск: поиск 
использовать: использовать используем 
исправить: исправлено 
существовать: существует существуют 
распаковка: распаковкой 
карма: карма 
доступный: доступной 
тип: типа тип типы типов 
найти: найдем 
работа: работы работа 
сложный: сложная 
копылов: копылов 
выразительный: выразительным 
идиоматичный: идиоматичный 
запись: записью запись записи записей 
деконструкция: деконструкцией 
современный: современным 
красота: красота 
преобразование: преобразовании 
скомбинировать: скомбинировать 
несколько: несколько нескольких 
интеграция: интеграция 
написать: написать напишите напишет 
проблема: проблема проблемы 
вернуть: вернет 
настройка: настройка 
сей: сих 
компактно: компактно 
монада: монады 
наивный: наивный наивное 
стать: статей станет стало стали 
вполне: вполне 
профиль: профиль 
моделирование: моделирование моделирования 
ситуация: ситуация 
образец: образец образцом образцами 
мочь: можем 
естественный: естественным 
лямбда: лямбд 
старый: старую 
программирование: программирования программирование программировании 
возможный: возможные возможных возможным 
значительно: значительно 
стандартный: стандартной стандартная 
экземпляр: экземпляр 
её: её 
вывести: выведет вывести 
крупный: крупными 
революция: революция революции 
декомпозиция: декомпозиции декомпозицией 
рабочий: рабочий 
это: это 
ознакомиться: ознакомиться 
обойтись: обойтись 
конструировать: конструировать 
складываться: складываться 
использование: использования использование использованием 
красивый: покрасивей 
получение: получения получение 
поддержка: поддержка 
тихо: тихо 
сам: сами 
тот: та той 
сравнить: сравнить 
особо: особо 
почему: почему 
неявно: неявно 
первый: первая первых 
позволять: позволяет позволяют 
хаба: хабы 
сопоставлять: сопоставляем 
несмотря: несмотря 
компилятор: компилятор компилятора 
образ: образом 
интерсептор: интерсептора 
туториал: туториал 
знать: знать знает 
эффективный: эффективное 
удобный: удобном удобные 
ваш: вашем 
замена: замена 
называть: называемая 
появиться: появится 
сумма: сумму 
который: которая которое 
объявлять: объявляем 
происходить: происходит происходили 
доставать: достаем 
приятный: приятный 
последний: последнюю последние последней последняя 
изоляция: изоляции 
изучить: изучить 
интерфейс: интерфейс интерфейсов интерфейса 
идти: идет идущей 
тег: теги 
средство: средства 
ниже: ниже 
уровень: уровень 
завершиться: завершиться 
прочтение: прочтение 
например: например 
предыстория: предыстории 
статья: статье статья статьи 
мнение: мнение 
возникнуть: возникнуть 
определять: определяет 
способ: способы 
кейс: кейса 
очень: очень 
генерик: генериков 
окончательный: окончательной 
контекст: контексте 
продолжение: продолжением 
привести: привести 
выход: выходом 
появление: появлением 
значимый: значимыми 
символ: символ 
явно: явно 
читатель: читатели 
получить: получить 
вывод: выводы выводом 
конкретный: конкретное 
действительно: действительно 
широко: широко 
применение: применением 
создать: создать 
подход: подхода 
кортеж: кортежей кортеж 
одномоментный: одномоментно 
затем: затем 
февраль: февраль 
хотя: хотя 
вместо: вместо 
сахар: сахар 
исходный: исходный 
написание: написания 
применять: применять 
поддаваться: поддается 
реализовать: реализовано 
де: де 
переменный: переменную переменной 
история: истории 
скомпилировать: скомпилировать 
логический: логическим 
комбинировать: комбинировать 
ценность: ценность 
средний: средний 
тихий: тихая 
определимый: определим 
вариант: вариантами варианты вариант 
конструктор: конструктор 
выпускаться: выпускаться 
конструкция: конструкция 
удаться: удалось 
хороший: лучшие хорошая 
вещь: вещь 
новый: новые 
имплементация: имплементация 
хотеться: хотелось 
следовать: следует 
лечиться: лечится 
второй: вторых вторая 
создавать: создаем 
подобный: подобный 
стадия: стадии 
покрывать: покрывает 
изменить: изменили 
дело: дело 
оба: оба 
мина: мин 
говорить: говорит говорить 
примитив: примитивов 
год: годы 
сутки: сутки 
измениться: изменился 
самый: самая 
безымянный: безымянный 
похожий: похожа похожие 
компактный: компактный 
успешный: успешные успешного 
разработчик: разработчик 
наследник: наследников 
изменение: изменения 
уважение: уважением 
выбросить: выбросить 
сергей: сергей 
вакансия: вакансии вакансий 
обогатить: обогатят 
ой: ой 
добавление: добавлением 
сравнивать: сравниваем 
экосистема: экосистему 
выйти: вышла 
каждый: каждом 
данные: данных 
носить: носит 
пример: примере примерах примера пример 
немного: немного 
нововведение: нововведения 
рейтинг: рейтинг 
й: й 
другой: другие других 
два: двух 
технический: техническая 
поиграться: поиграться 
количество: количество 
соответствовать: соответствующей 
пока: пока 
дополнительно: дополнительно 
производить: производящую 
либо: либо 
уметь: умеет 
закладка: закладки 
др: др 
пора: пор 
кстатит: кстатит 
вернуться: вернуться 
алгебраический: алгебраических 
многие: многие 
официально: официально 
хабра: хабр 
одновременный: одновременной 
код: код 
сложность: сложности 
момент: момент 
запомнить: запомнить 
итоговый: итоговый 
представимый: представим 
обновить: обновить 
название: название 
надеяться: надеюсь 
использоваться: используется 
время: время 
экспериментировать: экспериментировал 
вложить: вложенных 
просмотр: просмотров 
публикация: публикации 
традиционный: традиционный 
чистый: чистым 
сильный: сильной 
комбинирование: комбинирование 
набор: набор 
понятный: понятна 
локальный: локальную 
полезный: полезная 
изобретать: изобретать 
номер: номер 
финальный: финальной 
выглядеть: выглядеть 
казаться: кажутся 
компонент: компоненты 
обстоять: обстоит 
аналогичный: аналогичный 
интересовать: интересует 
мара: мар 
решить: решил 
нужный: нужный 
изолировать: изолированном 
картина: картина 
произойти: произошла 
вместе: вместе 
вообще: вообще 
фича: фичи 
указанный: указанного 
производиться: производится 
