ваш: ваш вашей 
изменять: изменять изменяющий изменяющих 
общий: общего 
выразительность: выразительности 
видеть: вижу 
задать: задать 
хм: хм 
единственный: единственное 
являться: является 
любой: любого любому любые любой 
поле: поле полей полями поля полю 
некоторый: некоторым 
действие: действия действий 
кодовый: кодовые кодовой 
база: базы 
внимание: внимание 
разработка: разработки 
яндекс: яндекс 
вариант: варианте 
потрудиться: потрудилась 
нужный: нужны нужному 
строка: строкой строка строки строк 
посмотреть: посмотри посмотрим 
какой: какими каком 
значение: значение значения значением 
средство: средств средствами средства 
пахнуть: пахнуть 
абстракция: абстракции 
функция: функция функции функциями функцию функций 
знать: знаете знаю знать знает 
один: одну одной 
комментарий: комментарии 
издательство: издательства 
голос: голосов 
разработчик: разработчики разработчиков разработчиками 
вызов: вызове вызова 
количество: количества количество 
преобразовать: преобразовано 
меню: меню 
должный: должны должна должен должно 
спецификация: спецификации спецификацию 
сложный: сложный сложными сложнее 
питер: питер 
факт: факту 
часть: часть частью части 
продолжать: продолжают продолжайте 
мочь: мог могла можете 
единица: единиц 
бороться: бороться 
хмм: хмм 
написать: написана написала написаны 
именно: именно 
понимать: понимаете понимаю 
часто: часто 
вид: виду 
преобразование: преобразование 
книга: книги книга книгой 
рассмотреть: рассмотрена 
имя: именем имена имени имен имя 
добавить: добавить добавите 
начинать: начинает 
год: лет 
точно: точно 
дом: дом 
знание: знания 
кто: кого 
выполняться: выполняться 
нужно: нужно 
сложность: сложностей сложность 
предназначить: предназначена 
крупный: крупную 
простой: проще 
сделать: сделать сделаем 
подход: подход 
язык: языка языке язык 
который: которые которой которая которых который которое 
идея: идея 
метод: метод 
дзен: дзен 
возможность: возможность 
раскрываться: раскрывалось 
дженна: дженна 
существующий: существующего существующие существующими существующей 
передать: передайте 
четыре: четыре 
поиск: поиск 
назначить: назначить 
словно: словно 
товар: товары товара товарам 
сайт: сайте сайт 
реализация: реализации 
карма: карма 
раскрытие: раскрытия 
заменить: заменить 
явный: явного явным явной явное явный 
рефакторинг: рефакторинг рефакторинга 
работа: работы 
класс: класса 
клиент: клиентами 
предоставить: предоставить 
ждать: ждать 
храниться: храниться 
иллюстрация: иллюстрации 
близкий: ближайших 
последовательность: последовательность 
цена: цену цены 
самолёт: самолете 
настройка: настройка 
обнаружить: обнаружить 
привести: приведены 
плохой: плох 
пугать: пугать 
жёстко: жестко 
профиль: профиль 
означать: означает 
аргумент: аргументе аргумента аргументом аргумент 
литература: литература 
координация: координации 
потребность: потребностям 
самый: самый 
облегчить: облегчит 
известный: известны 
первоклассный: первоклассное первоклассному первоклассным 
код: кода коду код коде 
научиться: научитесь 
стать: стал стало 
хаброжитель: хаброжители хаброжителей 
старый: старую старом 
программирование: программирования 
называть: называемый 
применение: применение 
уровень: уровня уровни 
тело: теле 
обратиться: обратиться 
массив: массиве 
языковой: языковых 
это: это 
ознакомиться: ознакомиться 
первый: первого первый 
электронный: электронная 
структура: структуре 
задача: задачу 
наш: нашу 
особый: особых 
выражение: выражением выражение 
поддержка: поддержка 
программист: программистов 
пример: примеры 
добавлять: добавляем 
почему: почему 
предотвратить: предотвратить 
тема: тема темой 
позволять: позволяет 
хаба: хабы 
поздний: позднее 
свой: своих 
похожий: похожи похожие похожим похож 
профессиональный: профессиональная 
похоже: похоже 
увеличивать: увеличивал 
подобный: подобных 
выглядеть: выглядит выглядят 
использование: использование 
приём: прием 
запрос: запросов запросы 
маркетинг: маркетингу маркетинга 
пользователь: пользователь 
состояние: состояние 
основный: основная 
дубликат: дубликатов 
удовлетворять: удовлетворяющие 
возразить: возразить 
узнать: узнаете узнаем 
неявный: неявным неявного неявный 
больший: большая большую 
такой: такое таким таких 
снова: снова 
становиться: становится становясь 
тег: теги 
небезопасно: небезопасно 
ниже: ниже 
указать: укажите 
надёжно: надежно 
задание: задания 
прочтение: прочтение 
новый: нового новыми новые новое новая 
например: например 
поезд: поезде 
передаваться: передается передаваться 
благодаря: благодаря 
оно: оно 
бумажный: бумажной 
разный: разные 
компания: компании компания 
сильно: сильно 
формат: формате 
согласовывать: согласовывать 
вопрос: вопросы вопрос 
сообщить: сообщить 
система: системы систему 
заметный: заметный 
очень: очень 
читать: читать 
корзина: корзине корзины 
каждый: каждого 
исправить: исправить 
кроме: кроме 
данный: данном 
позволить: позволил позволит 
передача: передачи 
действительно: действительно 
строковый: строковом 
сколько: сколько 
определять: определяющие 
фиксировать: фиксированного 
тонкий: тонкий 
просто: просто 
иметь: иметь 
говорить: говорите 
ситуация: ситуации 
запутанность: запутанность 
практический: практические практическим 
всё: всё 
запутанный: запутаннее 
акция: акций 
смысл: смысле 
определённо: определенно 
казаться: кажется 
иметься: имеется 
версия: версию версии 
хотя: хотя 
выявление: выявление 
доставка: доставку 
вместо: вместо 
обратить: обратить 
многопоточный: многопоточный 
закрепить: закрепить 
пользоваться: пользоваться 
также: также 
отдел: отдела отдел 
неизбежно: неизбежно 
превратить: превратить 
проблема: проблемами проблемы 
стиль: стиле 
команда: команду команде команда 
менее: менее 
страница: страницах 
обновление: обновление 
бесплатный: бесплатную 
обобщённый: обобщенной 
этот: эта этих 
мы: нам 
дублирование: дублирование 
купон: купону 
одинаковый: одинаковы 
прийтись: придется 
определимый: определим 
функциональный: функциональное 
иной: иное 
достаточно: достаточно 
дело: дела 
поступать: поступать 
представлять: представлять 
хороший: лучшие 
вычисление: вычисления 
произойти: произошло 
вчера: вчера 
предлагать: предлагал 
ранее: ранее 
попахивать: попахивает 
разрастаться: разрастаются 
оглавление: оглавление 
мина: мин 
предотвращать: предотвращают 
разита: разит 
задумать: задумано 
избавиться: избавиться 
смочь: сможете 
работать: работает работал работать 
сутки: сутки 
нравиться: нравиться 
логичный: логичнее 
статус: статусу 
переменный: переменной 
издательский: издательский 
барьер: барьер барьера 
использоваться: использоваться 
назначение: назначения 
читаемость: читаемость 
быть: будем будут 
удобный: удобный 
грокать: грокаем 
данные: данных 
добавление: добавление 
самопроверка: самопроверки 
абстрактный: абстрактного абстрактный 
асинхронный: асинхронный 
желательно: желательно 
направить: направленном 
высылаться: высылается 
рейтинг: рейтинг 
словарь: словарь 
другой: другие 
компоновать: компонуемые 
технический: техническая 
предполагаться: предполагается 
весь: всеми 
скидка: скидка 
пока: пока 
называться: называется 
полный: полный 
изменение: изменение 
заключаться: заключается 
неплохо: неплохо 
закладка: закладки 
пожалуй: пожалуй 
опыт: опытом 
вернуться: вернуться 
помочь: помогут 
честно: честно 
подробно: подробно 
мышление: мышление 
хабра: хабр 
ким: ким 
выполнить: выполнить 
главное: главное 
сталкиваться: сталкиваются 
различие: различие 
построить: построили 
обновить: обновить 
идентичный: идентичны 
признак: признаком признак 
время: время 
отрывок: отрывок 
присутствовать: присутствует 
значит: значит 
вынудить: вынужден 
способный: способную 
стоить: стоит 
просмотр: просмотров 
провести: провести 
заявка: заявку 
публикация: публикации 
рекламный: рекламных 
подавать: подавать 
писать: писать 
создавать: создающих 
применяться: применяться 
набор: набор 
оплата: оплаты 
среднее: среднего 
звучать: звучит 
обнулить: обнулить 
серьёзный: серьезный 
синхронизация: синхронизации 
заглянуть: загляни 
глава: главы 
ошибка: ошибками 
содержаться: содержится 
масштабирование: масштабировании 
открыть: откроете 
директор: директор 
случай: случае 
блог: блог 
проникать: проникают 
очевидный: очевидно 
душок: душком 
вообще: вообще 
высокий: высокого 
