повторить: повторить 
образный: образные образных образными образную 
система: системе систем 
частота: частотой частоте частотах частоту частот частота частоты 
конкретный: конкретную 
робот: робот 
аналоговый: аналоговые аналоговый 
спроектировать: спроектировать 
ответ: ответ 
оставить: оставить 
применение: применения 
влиять: влияет влиять 
предел: пределы 
радиоприёмник: радиоприемнике 
чебышёв: чебышева 
входной: входного входной входные 
внимание: внимание 
допустить: допустим 
расчёт: расчетах расчета расчет 
находка: находки 
яндекс: яндекс 
обработка: обработки 
добиться: добиться 
напряжение: напряжение напряжения напряжению 
высокий: высоких 
получиться: получится получилось 
метод: методы 
какой: какими какую какие 
значение: значение значения 
малый: малая 
индуктивность: индуктивностей индуктивности индуктивностью индуктивность 
возможно: возможно 
простой: простое проще 
соответственно: соответственно 
микроконтроллер: микроконтроллеров 
лишний: лишние 
активный: активные 
знать: знаете зная 
пятый: пятого 
один: одну одном одному 
игнорировать: игнорировать 
комментарий: комментарии 
голос: голосов 
разработчик: разработчики разработчиком 
назвать: названных 
очередной: очередной 
ачх: ачх 
готовый: готово 
сигнал: сигнал сигнала сигналы 
количество: количества количество 
выход: выходам выход 
меню: меню 
должный: должны 
соединить: соединенными 
задерживать: задерживает 
вч: вч 
плата: плату плате 
выходной: выходную выходной выходных выходного 
переменный: переменные переменный переменного 
часть: часть 
следующий: следующими следующие следующей 
масштаб: масштабы масштабе 
крутой: крутым крутого круче крутой 
пылесос: пылесос 
фильтр: фильтрах фильтром фильтра фильтры фильтров фильтре фильтр фильтрами 
база: базе 
безопасность: безопасности 
синий: синего синий 
шум: шумов 
именно: именно 
устройство: устройстве устройств устройство 
порядок: порядок порядка порядков 
часто: часто 
гомеопатия: гомеопатия 
дело: деле дел 
такой: такими такое такого такому такая 
больший: большее больших большим 
последовательно: последовательно 
рассмотреть: рассмотрена рассмотрели 
резистор: резисторах резистора резистор 
добавить: добавить 
сам: самой самом сами 
точно: точно 
спад: спада спад спадом 
выравнивать: выравнивать 
частый: чаще 
помощь: помощью 
супергетеродин: супергетеродина супергетеродинах 
полосовой: полосового полосовые полосовой 
видно: видно 
нижний: нижних 
определённый: определенную определенной 
справа: справа 
схематически: схематически 
равно: равно 
формула: формулы формулах 
поговорить: поговорим 
выбирать: выбирая выбираете выбирают 
конденсатор: конденсатора конденсаторе конденсатор 
номинал: номиналов номиналам номиналами номиналы 
язык: языка язык 
который: которые которой которая которую 
неравномерность: неравномерность 
аудиосигнал: аудиосигналов 
схема: схема схему схемы 
дзен: дзен 
полезный: полезный 
падать: падает 
ефименко: ефименко 
электроника: электроники электроника 
прямо: прямо 
трансформаторный: трансформаторных 
рассчитать: рассчитали рассчитанные рассчитать 
увеличивать: увеличивая 
посмотреть: посмотрим посмотрите 
поиск: поиск 
тот: те та 
использовать: использовать используют используйте 
резистивный: резистивного резистивный 
лишь: лишь 
график: график 
вход: вход 
ток: току токи ток тока 
карма: карма 
профессиональный: профессиональной 
делитель: делителя делитель 
программный: программные 
работа: работы 
измерять: измерять 
век: века 
выровнять: выровнять 
быть: будете суть будут 
сохранять: сохраняйте 
ёмкость: емкости емкостей емкостью емкость 
уменьшаться: уменьшается 
принцип: принцип принципу 
селективность: селективности 
означать: означают 
вычислительный: вычислительной 
катушка: катушке катушку катушки 
далее: далее 
инусоида: инусоида 
большой: большого 
электрический: электрическая электрический электрических 
поменять: поменять 
задать: заданным 
специальный: специальные 
реактивный: реактивное 
заграждение: заграждения 
настройка: настройка 
ключевой: ключевые 
следовательно: следовательно 
обычный: обычных обычные 
показание: показаний 
декада: декадах 
связь: связи 
математический: математические 
вполне: вполне 
полоса: полоса полосу полосе полосы 
профиль: профиль 
наклон: наклоном наклон наклона 
принимать: принимаете принимает 
правильно: правильно 
маленький: меньше 
ситуация: ситуация 
постепенно: постепенно 
мочь: можем можете 
обозначать: обозначают 
анализатор: анализатор 
начало: начала 
выходить: выходящие 
отличаться: отличаться 
самый: самый самых самым самые 
характеристика: характеристику характеристикой характеристики 
ки: ки 
уклонение: уклонение 
проектирование: проектировании 
предварительно: предварительно 
сопротивление: сопротивления сопротивлений сопротивление 
геймифицировать: геймифицировать 
старый: старую 
администрирование: администрирования 
графика: графика 
книга: книгу 
этот: этому 
частотный: частотный частотные частотного частотными частотных 
срез: среза срез 
методика: методики методику 
раз: раза 
преобразование: преобразования 
генератор: генератор 
случиться: случится 
заградительный: заградительные заградительный заградительного 
приёмник: приемники приемниках приемника 
усилитель: усилителей усилителях 
профилактика: профилактики 
затухание: затухания 
г: г 
осциллограф: осциллограф 
встретить: встретить 
красивый: красивые 
высокочастотный: высокочастотным 
теория: теорию 
элемент: элементе элемент элементов 
собирать: собираем 
это: это 
место: местами 
электронный: электронно 
ёмкостный: емкостное 
иметь: имеет 
кой: кое 
подключить: подключенный подключить 
применять: применяют 
цепь: цепей цепях цепь 
атака: атак 
поддержка: поддержка 
обзор: обзор 
запомнить: запомните 
пология: пологий 
электротехника: электротехника 
квадратный: квадратные 
разница: разница 
правый: правы 
особо: особо 
видеть: видите 
почитать: почитать 
первый: первая 
позволять: позволяет 
хаба: хабы 
протекать: протекает 
качественный: качественные 
разный: разному 
супер: супер 
разбираться: разбираться 
топология: топологии 
макетный: макетную 
фвч: фвч 
перекосить: перекосило 
выглядеть: выглядит 
согласиться: согласитесь 
упомянуть: упомянули 
определить: определить 
обратно: обратно 
хороший: хорошую лучшие 
сборка: сборки 
длительность: длительности 
жёлтый: желтого 
бизнес: бизнеса 
практика: практике 
плоский: плоской 
форма: формы 
качество: качестве 
верхний: верхних 
переходный: переходного 
оказывать: оказывает 
учёт: учета 
ослабление: ослабление 
шипение: шипение 
свойство: свойствах 
среди: среди 
плохой: плохой 
перенести: перенести 
многозвенный: многозвенными 
идти: идет 
радиоприёмный: радиоприемное 
включение: включении 
обычно: обычно 
полином: полиномах полиномов 
тег: теги 
баттерворт: баттерворта 
текст: тексты текст 
аренда: аренду 
выделить: выделить 
ниже: ниже 
уровень: уровень 
величина: величины 
оказываться: оказывается 
внутренний: внутренней 
слушать: слушать 
прочтение: прочтение 
радиостанция: радиостанциях 
например: например 
оно: оно 
рассчитывать: рассчитывать 
предпочитать: предпочитают 
компания: компании 
особенно: особенно 
делать: делать 
сильно: сильно 
статья: статье 
гармонический: гармонических 
нормировать: нормированные 
индуктивный: индуктивное 
эквалайзер: эквалайзер эквалайзерах 
теоретический: теоретических 
калькулятор: калькулятор 
область: область 
очень: очень 
построение: построения 
читать: читать 
смартфон: смартфоне 
получить: получим получить 
важный: важный 
логарифмический: логарифмическом 
выбираться: выбирается 
аналитический: аналитических 
операционный: операционных 
сервер: серверов 
источник: источника 
напоминать: напоминает 
удовлетворять: удовлетворяет 
координата: координат 
передача: передачи 
слева: слева 
онлайн: онлайн 
техника: технике 
передавать: передающих передающем 
широко: широко 
условие: условиям 
барахолка: барахолке 
панель: панелью 
появляться: появляется 
электротехник: электротехнику 
амплитуда: амплитуду 
практический: практических 
просто: просто 
производство: производство 
таблица: таблицу 
радиотехник: радиотехнике радиотехника 
аспект: аспектов 
важно: важно 
подробный: подробнее 
комплексный: комплексных 
версия: версию 
коэффициент: коэффициента коэффициент 
вместо: вместо 
режекторный: режекторный режекторного 
фпч: фпч 
использоваться: используются 
проверить: проверим проверил 
смотреть: смотрите 
понять: понять 
указывать: указывает 
стать: стало 
также: также 
превратить: превратить 
роутер: роутере 
мгц: мгц 
проблема: проблемы 
препятствие: препятствием 
работать: работают работает 
выделять: выделять 
зеркалка: зеркалка 
вычисление: вычислениях 
линейный: линейном 
обратить: обратите 
экономический: экономических 
синусоида: синусоиду 
опираться: опираясь 
сложный: сложней 
тип: тип 
средний: средний 
параметр: параметры параметрами параметрах параметр 
диапазон: диапазоном диапазона 
фнч: фнч 
достаточно: достаточно 
прямой: прямого 
фронт: фронта фронт 
ответить: ответить 
вариант: варианты 
выражение: выражению 
рекомендовать: рекомендую 
пропускать: пропускает 
новый: новые 
вчера: вчера 
лёгкий: легче 
треугольный: треугольные 
бессель: бесселя 
отразить: отразить 
сайт: сайт 
нужный: нужную нужными 
отметить: отметить 
учитывать: учитывают 
мина: мин 
добротность: добротность 
увеличение: увеличением увеличении 
десять: десять 
показать: покажет 
неоднозначный: неоднозначный 
многообразие: многообразия 
избавиться: избавиться 
давать: давайте дает 
связать: связав связаны связано 
суть: сути 
сутки: сутки 
идеальный: идеальной идеальную 
увеличиваться: увеличивается 
п: п 
другой: другая другие 
мера: меры 
ширина: ширина 
весь: всем 
дб: дб 
влад: влад 
измерительный: измерительной 
октав: октава октаву 
результат: результаты 
выше: выше 
навигация: навигацию 
зависимость: зависимость 
низкий: низких 
имитация: имитация 
задержание: задержания 
правило: правило 
вычисляться: вычисляется 
наука: наука 
типичный: типичная 
установить: установить 
мв: мв 
немного: немного 
хотеть: хотите 
рейтинг: рейтинг 
крутизна: крутизны 
писатель: писатель 
каждый: каждый 
вконтакте: вконтакте 
говорить: говорить 
разработка: разработка 
технический: техническая технический 
сложно: сложно 
второй: второго 
объединять: объединяющая 
эффект: эффекта 
литература: литературе 
полностью: полностью 
обладать: обладает 
цвет: цвета 
составить: составить 
вид: видов 
доля: долю 
функция: функций 
гораздо: гораздо 
программа: программа 
буквально: буквально 
закладка: закладки 
заинтересовать: заинтересуют 
понадобиться: понадобится 
яркий: яркий 
ваш: вашего 
прекрасный: прекрасном 
последний: последнее 
явный: явный 
пропускание: пропускания 
похожий: похожие 
плавный: плавный 
схемотехник: схемотехники схемотехника 
вернуться: вернуться 
контур: контуры 
инфраструктура: инфраструктура 
представить: представьте 
эффективно: эффективно 
хабра: хабр 
знакомство: знакомство 
любой: любой любом 
сложность: сложности 
пропорционально: пропорционально 
схемотехнический: схемотехнического 
бывать: бывают 
неравномерный: неравномерные 
проходить: проходящего 
стабильный: стабильна 
обновить: обновить 
состоять: состоят 
два: две 
время: время 
сумма: суммы 
саллен: саллена 
схитрить: схитрить 
никак: никак 
сэкономить: сэкономить 
скидка: скидкой 
стоить: стоит 
просмотр: просмотров 
фазочастотный: фазочастотную 
публикация: публикации 
соображение: соображений 
так: т 
свой: своя 
утонуть: утонуть 
узнать: узнать узнал 
приёмный: приемно 
отношение: отношение 
подобрать: подобрать 
вести: вести 
привычный: привычного 
поставить: поставить 
колебание: колебаний колебания 
о: обо 
наоборот: наоборот 
синусоидальный: синусоидальные 
счёт: счет 
оранжевый: оранжевый 
цифровой: цифровые 
начинающий: начинающих 
стараться: стараются 
сказать: сказать 
проигнорировать: проигнорировать 
поймать: поймать 
регулировать: регулировать 
блог: блог 
пример: пример 
параллельно: параллельно 
отдельный: отдельная 
основать: основан 
рисунок: рисунки 
усиливать: усиливаемого 
сильный: сильнее 
участок: участка 
помогать: помогают 
бесконечный: бесконечное 
