оказаться: оказаться 
мочь: могут 
ваш: ваш 
управление: управление управления 
задача: задачи задача 
версия: версий версию версии версия 
прежний: прежнему 
приложение: приложения приложений 
большой: большой 
развитой: развитой 
поддерживать: поддерживают поддерживать поддерживал поддерживает 
эксплуатация: эксплуатации 
являться: является являются 
продукт: продуктах продукты 
учитывать: учитывая учитывать 
предприятие: предприятия 
внимание: внимание внимания 
давно: давно 
новый: новым нового новое новый 
присылать: присылают присылать 
яндекс: яндекс 
выбирать: выбирать 
приобрести: приобрести 
метод: методы 
какой: какими каким какие 
решение: решениями решений решение решения 
успешно: успешно 
дистрибуция: дистрибуции 
платёжный: платежных 
напрямую: напрямую 
сам: самого 
облачный: облачном облачному 
комментарий: комментарии 
организовать: организовать 
пользователь: пользователям пользователь пользователю 
организация: организациям организациях 
голос: голосов 
разработчик: разработчики разработчиков 
обеспечение: обеспечение обеспечения 
вытеснить: вытеснили 
инфраструктура: инфраструктурой инфраструктура 
знание: знаниями 
меню: меню 
должный: должны должен 
внедрение: внедрения 
функция: функции функциями 
офисный: офисных офисного офисным офисное офисный офисные офисном 
команда: командой команды 
ценовый: ценовая ценовую 
требование: требованиям 
бесперебойный: бесперебойной 
сторонний: сторонние сторонними 
сила: силу 
безопасность: безопасности безопасность 
самый: самыми самая 
отечественный: отечественное отечественного 
часто: часто 
миграция: миграция 
вручную: вручную 
подписка: подписки 
добавить: добавить 
год: лет году 
однако: однако 
зависеть: зависит 
частый: чаще 
помощь: помощью 
критерий: критерий 
подключение: подключения 
включить: включенные 
сертифицированный: сертифицированным 
календарь: календари 
прямой: прямым 
важный: важными важный 
сделать: сделать 
чересчур: чересчур 
язык: языка язык 
который: которые 
глубокий: глубокими 
требовать: требует требуют требовать 
дзен: дзен 
возможность: возможность 
прекращение: прекращении 
недоступный: недоступны 
значительный: значительные 
стоимость: стоимость 
делать: делают 
характеристика: характеристиками 
три: трех 
поиск: поиск 
единый: единой 
программный: программного программные программное 
полноценный: полноценные 
код: кодом 
применительно: применительно 
карма: карма 
соцсеть: соцсетей соцсетях 
профессиональный: профессиональной 
компьютер: компьютере 
встроить: встроенных встроенные 
дополнительный: дополнительных дополнительные дополнительного 
работа: работы работу работа 
многопрофильный: многопрофильных 
рабочий: рабочем рабочий 
распределять: распределять 
информационный: информационной информационная 
несколько: несколько нескольких 
файл: файлов файла файлы 
смежный: смежных 
сегодня: сегодня 
ответственный: ответственного 
настройка: настройка 
необходимо: необходимо 
обмениваться: обмениваться 
инженерный: инженерно 
профиль: профиль 
программа: программу программ программам программы 
зависимость: зависимости 
проделать: проделали 
обращать: обращать 
бизнес: бизнесу бизнеса бизнес 
гибкий: гибкую 
необходимость: необходимостью необходимость 
далеко: далеко 
совместный: совместного совместной 
электронный: электронную 
пк: пк 
означать: означает 
делопроизводство: делопроизводства 
внутренний: внутренний внутренних 
китайский: китайский 
мессенджер: мессенджеры мессенджере мессенджеров мессенджера 
такой: такую 
старый: старую старые 
использовать: используют 
российский: российские российским российский 
годовой: годовой 
чат: чатов чаты 
обмен: обмен обмена 
крупный: крупными крупного 
наличие: наличие 
проект: проектами 
россия: россии 
многий: многих 
руководитель: руководителей 
непросто: непросто 
это: это 
предложить: предложить 
развить: развитая 
текстовый: текстового текстовые 
вариант: вариантах вариант 
распространить: распространены 
применять: применяют 
поддержка: поддержка поддержкой поддержки 
редактор: редактор редактора редакторов редакторы 
сохранение: сохранение 
обладать: обладать обладающие 
технический: технических техническим техническая технической 
функционал: функционал 
сервис: сервисами сервисом 
потребность: потребностей 
сравнить: сравнить 
хранить: хранить 
сеть: сеть 
политика: политика политику 
уход: ухода 
хаба: хабы 
рамка: рамках 
современный: современные современный 
несмотря: несмотря 
предлагаться: предлагается 
адаптировать: адаптировано 
пакет: пакетом пакете пакеты пакет 
использование: использование 
внутри: внутри 
время: времени время 
органайзер: органайзерами 
частный: частному 
документ: документами документов 
максимальный: максимального 
умолчание: умолчанию 
гигант: гиганты 
партнёрский: партнерская 
переход: переход переходе 
план: плане 
р: р 
становиться: становится 
тег: теги 
браузер: браузера 
оказываться: оказывается 
уровень: уровень 
офис: офис 
ресурс: ресурсов 
прочтение: прочтение 
трата: трата 
сотрудник: сотрудниками сотрудников сотрудника сотрудникам 
например: например 
партнёр: партнеры 
оно: оно 
редактирование: редактирования 
поэтому: поэтому 
платформа: платформ 
разметка: разметки 
максимально: максимально 
компания: компании компаниями 
софт: софт софта 
статья: статье 
коммуникация: коммуникации 
формат: формате форматов форматы 
состав: составом 
специалист: специалист 
технологический: технологических 
вендор: вендорами вендоры 
путь: путь 
системный: системный 
извне: извне 
синхронизировать: синхронизировать 
каждый: каждого 
данные: данными данных 
сложный: сложным 
открытый: открытым 
зарубежный: зарубежных 
небольшой: небольшой 
привести: привести 
помочь: помочь 
число: числа 
разный: разных 
часть: частью 
предлагать: предлагают предлагает предлагаемые 
получить: получить 
сервер: серверах 
объявить: объявили 
поставщик: поставщиков 
онлайн: онлайн 
высокий: высокой 
вопрос: вопросе вопрос 
опция: опцию опций 
некоторый: некоторых некоторые 
тестирование: тестирования 
правка: правками 
канал: канал 
важно: важно 
подходящий: подходящую подходящий 
конкретный: конкретной конкретного 
вместо: вместо 
обратить: обратить 
использоваться: используются 
соответствовать: соответствовать 
закладывать: закладывать 
производитель: производителя 
стать: стало стали 
бюджет: бюджет 
бесшовный: бесшовно 
цена: цены 
плюс: плюсом 
уверенность: уверенность 
история: истории 
рынок: рынка рынок 
контролировать: контролируемых 
большинство: большинство 
коробочный: коробочном 
передаваемый: передаваемых 
последний: последние 
инструмент: инструменты 
практически: практически 
хороший: лучшие 
рациональный: рациональная 
нужный: нужные 
претерпеть: претерпел 
убыток: убыткам 
информация: информацию информации 
почта: почту 
исправить: исправленный 
опытный: опытные 
служба: службы 
диск: диск 
мина: мин 
позволять: позволяют 
аргумент: аргументом 
корпоративный: корпоративные корпоративного 
облако: облаке 
исходный: исходным 
сутки: сутки 
проблема: проблемой 
дорого: дорого 
приобретение: приобретение 
крайне: крайне 
офлайн: офлайн 
смена: смене 
подразделение: подразделений 
администратор: администратор 
выбор: выборе 
изменение: изменения 
критично: критично 
вакансия: вакансии вакансий 
создаваться: создаются 
режим: режим 
юридический: юридической 
особенность: особенностей 
установить: установить 
расширение: расширения 
хранилище: хранилищу 
вроде: вроде 
рейтинг: рейтинг 
реестр: реестр 
выбрать: выбрать выбранного 
другой: другие других 
предусмотреть: предусмотрена 
доступ: доступ 
быстрый: быстрой 
весь: всей 
популярный: популярных 
немой: нем 
настолько: настолько 
больший: большим 
количество: количество 
пользовательский: пользовательской 
оптимизировать: оптимизировать 
перспективный: перспективными 
закладка: закладки 
простой: простой 
обсудить: обсудить 
любой: любая любом 
похожий: похожие 
вернуться: вернуться 
модель: модели 
интерфейс: интерфейсом 
многие: многие 
утечка: утечкам 
записывать: записывать 
внедрять: внедрять 
хабра: хабр 
сложность: сложности 
летучка: летучках 
главное: главное 
адекватный: адекватная 
блок: блоков 
синхронизация: синхронизацию синхронизации 
уверить: уверено 
обновить: обновить 
десктопном: десктопном 
разобраться: разобраться 
сохранить: сохранить 
минимум: минимум 
дать: данные 
серверный: серверная серверном 
открыть: открыть 
десктопный: десктопную десктопных 
значит: значит 
эффективность: эффективность 
эффективный: эффективные 
стоить: стоит 
просмотр: просмотров 
публикация: публикации 
десяток: десятков 
ноутбук: ноутбук 
помнить: помнить 
решать: решают 
главный: главным 
лицензия: лицензий 
происходить: происходил 
гарантировать: гарантируют 
способный: способны 
интеграция: интеграции 
полный: полным 
случай: случае 
расход: расходы 
попробовать: попробуем 
доска: доску 
быстро: быстро 
основной: основные 
продолжение: продолжении 
мара: мар 
нередко: нередко 
выделить: выделенных 
установка: установки 
запрет: запретом 
переносить: переносить 
столь: столь 
система: систем 
включать: включают 
