сравнивать: сравнивать 
вход: входе 
рисоваться: рисуется 
приложение: приложения приложении приложение приложений приложением 
вызываться: вызывается 
придумать: придумать придумали 
различный: различных 
квадрат: квадрате 
спроектировать: спроектировали 
двумерный: двумерные 
обойти: обошло 
поддерживать: поддерживать 
влиять: влияющих 
простой: простые 
область: области 
являться: является 
изображение: изображение 
определённый: определённого определенным определенном 
тратить: тратить 
узел: узла узлы узлов 
действие: действия 
работать: работали работает 
соответствовать: соответствующим 
целевой: целевого 
яндекс: яндекс 
нужный: нужны нужные нужен 
невероятно: невероятно 
локально: локально 
проверка: проверок проверки 
наш: наше нашим нашего нашей нашему наша 
каждый: каждой каждом каждый 
видеокарта: видеокарте видеокарты 
получать: получать 
игнорировать: игнорировать 
один: одну одном одно одних 
комментарий: комментарии 
голос: голосов 
основа: основам основе 
крутить: крутить крутит 
сторона: стороной стороне сторону 
состояние: состояния 
готовый: готово 
анимация: анимации 
страница: страницу странице 
меню: меню 
должный: должны должна должно 
потребность: потребность 
посмотреть: посмотреть 
гонять: гонять гоняли 
который: которыми которая которых которое котором 
стиль: стиль стиля 
контроль: контроля 
сервис: сервисов сервисы 
часть: часть 
регрессия: регрессию 
размер: размер 
база: базе 
зум: зум зума 
пиксель: пикселей 
поведение: поведение 
взаимодействие: взаимодействие взаимодействия 
добраться: добрались 
вручную: вручную 
поискать: поищем поискать 
приходить: приходите 
служебный: служебное 
слабенький: слабенькое 
тестирование: тестировании тестированию тестирования тестирование 
полный: полную 
добавить: добавить 
цвет: цвет 
год: лет 
появиться: появился появится 
пункт: пункта пункт 
зависеть: зависит 
нужно: нужно 
позволять: позволяющих позволяющий 
ужасно: ужасно 
пользователь: пользователя пользователь 
расстояние: расстояние 
упавший: упавший 
статичный: статичная 
пиксельный: пиксельной 
вид: виде видов вид 
сделать: сделать сделанный 
подход: подход 
язык: языка язык 
убедиться: убедимся 
подробность: подробностей 
создаваться: создаётся 
дзен: дзен 
возможность: возможность 
реализация: реализация 
попробовать: попробовал попробовать 
итог: итоге 
геоинформационный: геоинформационные 
результат: результатом результат 
прямо: прямо 
относительно: относительно 
земля: земли 
сервер: сервер сервера 
загрузка: загрузки 
основный: основным 
передача: передачу 
поиск: поиск 
видимый: видимой 
использовать: использовать 
смотреть: см смотреть 
существовать: существует 
старый: старому старую 
возненавидеть: возненавидел 
код: кодом код 
карма: карма 
вызывать: вызывает 
тип: типа типов 
ценить: ценить 
событие: события событие 
работа: работы 
измерять: измерять 
сущий: сущим 
кликать: кликать 
совершенно: совершенно 
современный: современным 
конвейер: конвейера 
вычисление: вычислений 
зоопарк: зоопарк 
обновиться: обновятся обновилось обновится 
гис: гис 
настройка: настройка 
продакшн: продакшн 
дефолтный: дефолтный 
сожаление: сожалению 
следовательно: следовательно 
треугольник: треугольники треугольников треугольниками 
разобраться: разобрались 
серия: серии 
профиль: профиль 
появление: появления 
правильно: правильно 
подключить: подключенным 
маленький: меньше 
дебаг: дебага 
адрес: адресу 
перерисовывать: перерисовывать 
тот: тех ту 
предоставлять: предоставляющая 
мочь: можем можете 
проверять: проверять 
душа: душе 
привычка: привычке 
нарисованность: нарисованность 
низкоуровневый: низкоуровневому 
образ: образ образом 
запихать: запихать 
такой: такую 
тестировать: тестировать 
технический: техническими технических техническая 
приближать: приближать 
частый: частая 
этот: этому этих 
невозможно: невозможно 
комбинировать: комбинируем 
здание: здания зданий 
актуализировать: актуализировать 
актуальный: актуальные актуальная 
поддерживаться: поддерживается 
он: нему 
создавать: создаём создаёт 
учитывать: учитывает 
её: её 
содержимое: содержимым 
флаг: флагом 
обратиться: обратиться 
наклон: наклон 
туториал: туториалу 
говорить: говоря 
это: это 
начинать: начинать начинаем 
устройство: устройство устройства 
учёт: учёта 
визуализировать: визуализируем визуализированными 
фреймворк: фреймворк 
отрисовка: отрисовки отрисовку отрисовка 
тест: тестов тесты теста тест 
понятно: понятно 
объект: объектах объектов объекту объект объекты объекта объектами 
внешний: внешний 
запрос: запрос 
команда: команды команда 
вариативность: вариативности 
поддержка: поддержка 
тайла: тайлы 
конечный: конечные 
быть: е будем 
сегмент: сегмента 
визуально: визуально 
хранить: хранить 
прийтись: придётся пришлось 
пропустить: пропустили пропустить 
собираться: собираться 
запаковать: запакованная 
потребоваться: потребуется 
хаба: хабы 
замокать: замокать 
система: системах систем 
количество: количеству количество 
создать: создали создать созданные 
взять: взять 
заниматься: занимается занимаются 
скриншот: скриншотом скриншоты скриншотов скриншот 
тайловыя: тайловый 
стабильность: стабильность 
браузер: браузерах браузера браузер браузере браузерами 
нарисовать: нарисованный нарисовать 
успешность: успешность 
умолчание: умолчанию 
ещё: ещё 
происходить: происходит происходить 
незаметно: незаметно 
проблема: проблем 
загружать: загружает 
положение: положение 
множество: множества 
качество: качестве 
рисовать: рисует рисуем рисовать 
экран: экране 
слишком: слишком 
задача: задачами 
интерфейс: интерфейс 
хотеть: хотим 
обновляться: обновляются 
течение: течение 
тег: теги 
знать: знает 
какой: каких 
городской: городской 
прочтение: прочтение 
хороший: хорош лучшие хорошая 
например: например 
специальный: специальным 
поэтому: поэтому 
визуализация: визуализация визуализации 
история: история 
максимально: максимально 
компания: компании 
делать: делать делает 
кусочек: кусочек 
статья: статье 
первый: первый первую 
непосредственно: непосредственно 
несколько: нескольких 
выполнять: выполнять 
плавно: плавно 
неудобно: неудобно 
очень: очень 
запуск: запуска 
популярный: популярном 
переменный: переменных 
получить: получим 
данные: данными данных 
операционный: операционных 
разный: разных 
человек: люди 
карта: карту картой карта картам карты карте 
запись: запись 
онлайн: онлайн 
день: день 
продуктовый: продуктовые 
исходить: исходя 
подобать: подобает 
пригождаться: пригождается 
запустить: запущен запустить 
окружение: окружений окружения окружениях окружение окружении 
достоинство: достоинству 
копия: копия копию 
меняться: менялся 
просто: просто 
клик: клике 
дождаться: дождавшись 
изобрести: изобрели 
торопиться: торопиться 
повторять: повторяет 
кликнуть: кликнули 
важно: важно 
всё: всё 
айдишник: айдишником 
назад: назад 
казаться: кажется 
сам: само 
версия: версию версии версия 
конкретный: конкретной конкретном конкретного 
экспериментальный: экспериментальной 
сентябрь: сентябрь 
окей: окей 
навигация: навигации 
программный: программный 
понять: понять 
подвинуться: подвинется 
стать: стало 
также: также 
минута: минуту 
поворот: поворот 
сложный: сложного 
идеал: идеале 
менее: менее 
играючи: играючи 
возникнуть: возникнет 
дебажить: дебажить 
столкнуться: столкнуться 
мы: нам 
картографический: картографические картографических 
инспектор: инспекторе 
хотеться: хочется хотелось 
масштаб: масштабе 
совпадать: совпадать 
дожидаться: дожидаться 
ответ: ответа 
рассказать: расскажем 
кратный: кратный 
библиотека: библиотеки библиотекой библиотека 
параметр: параметры параметров 
завершение: завершение завершения 
инструмент: инструменты инструментов 
включаться: включалась 
управлять: управлять 
векторный: векторные 
представлять: представлять 
преобразовать: преобразует 
новый: новые новое новая новый 
вчера: вчера 
ожидание: ожидание 
ранее: ранее 
баг: баг 
сайт: сайт 
графический: графическим 
одновременно: одновременно 
цифра: цифр 
дело: дело 
мина: мин 
создаться: создался 
автотест: автотесты 
спокойно: спокойно 
десять: десять 
веб: веб 
нечего: нечего 
увеличение: увеличении 
сутки: сутки 
кратенько: кратенько 
ад: адом 
изменение: изменения 
платформа: платформах 
разработчик: разработчиков 
переход: переходе 
корректность: корректностью 
выход: выходе 
особенность: особенностей особенности 
боль: боль 
пропасть: пропадёт 
примерно: примерно 
пример: примере примеров 
отдельный: отдельным отдельная 
геометрия: геометрии геометрия 
совершать: совершать 
информация: информации информация 
рейтинг: рейтинг 
процессор: процессором 
перформанс: перфоманса 
справляться: справляющиеся 
локализация: локализация 
сомнение: сомнения 
подготовить: подготовить 
выбрать: выбрать 
другой: другие другое других 
ретраить: ретраить 
доступ: доступ 
уметь: уметь умеет 
свой: своей 
сложно: сложно 
предполагаться: предполагается 
дальнейший: дальнейших 
полностью: полностью 
весь: всеми 
отсутствие: отсутствие 
попиксельный: попиксельно 
общий: общий 
главный: главные 
артефакт: артефактов 
полноценный: полноценный 
понимание: понимания 
поменять: поменял 
довольно: довольно 
буквально: буквально 
закладка: закладки 
кейс: кейсов 
шаг: шагу 
похожий: похожие 
эталонный: эталонных 
вернуться: вернуться 
дерево: дереве 
хабра: хабр 
мощный: мощные 
таки: таки 
вырастать: вырастают 
выполнить: выполнить 
сразу: сразу 
долго: долго 
любить: любить 
главное: главное 
точность: точностью 
потенциально: потенциально 
специалист: специалисты 
жить: жить 
обновить: обновить 
обращаться: обращался 
научиться: научимся 
проверить: проверить 
минимум: минимум 
время: время 
продакшний: продакшне 
дать: данные 
услышать: услышать 
плавность: плавности 
лицо: лицом 
собраться: собрались 
спотыкаться: спотыкаться 
начертание: начертание 
открыть: открыть 
максимум: максимум 
просмотр: просмотров 
необходимость: необходимости 
публикация: публикации 
никакой: никаких 
писать: писать 
новость: новость 
решение: решения 
источник: источник 
фигура: фигуры 
формат: формат 
узнать: узнать 
набор: набор 
аналоговый: аналоговой 
кроссбраузерный: кроссбраузерного 
подобрать: подобрать 
отличие: отличие 
они: ними 
захостить: захостить 
собственный: собственный 
сохранять: сохранять 
непредсказуемый: непредсказуемы 
запускать: запускает 
смочь: сможет 
отвечать: отвечают 
блог: блог 
половина: половины 
быстро: быстро 
понятный: понятный 
создание: создания 
картинка: картинку 
отдалять: отдалять 
вообще: вообще 
фича: фичи 
компонент: компонентов 
плохой: плохая 
