турбулентный: турбулентные 
мочь: могут можем 
вывернуть: вывернутую 
задача: задачи задача задач 
клиент: клиентам 
игра: игры игре играх игр 
выраженный: выражен 
симулятор: симуляторах симулятора симуляторе симуляторы симуляторов симулятор 
реальность: реальности 
маска: маску маской 
свой: своего свои своей 
небесный: небесного 
четырехканальный: четырехканальную четырехканального 
самый: самую самый самых самая самые 
детейл: детейл детейла 
считаться: считается 
влиять: влияет влияют 
являться: является являются 
рендёр: рендера рендер рендере 
железо: железа 
текстура: текстуру текстура текстурами текстур текстуры текстурой 
представлять: представляющие представляют 
изображение: изображение изображениях изображении изображения 
трёхмерный: трёхмерной трехмерные трехмерной трехмерную 
имитировать: имитировать 
летать: летают 
крупный: крупный крупных крупные 
изотропный: изотропная изотропное 
давно: давно 
нойз: нойза нойз 
один: одного одну одним одна одной 
шум: шумы шума шум 
внимание: внимание 
светиться: светятся 
интенсивность: интенсивности интенсивностью интенсивность 
тайлить: тайлить 
особенность: особенность 
яндекс: яндекс 
поскольку: поскольку 
нужный: нужны нужной нужна 
добиться: добиться 
купол: купола 
значение: значение значений 
дополнить: дополненная 
небо: небом небо небе неба 
фотореалистичный: фотореалистичные 
режим: режиме режима 
обусловить: обусловлен 
соответственно: соответственно 
визуальный: визуальных визуальной 
пилот: пилоты пилотам пилотов 
среднее: среднем 
реализовать: реализованы реализован 
дальний: дальние дальнем 
напрямую: напрямую 
сам: самого самой самом сами 
покрытие: покрытием покрытия покрытие 
система: система систему 
функция: функция 
плоскость: плоскости 
аппроксимация: аппроксимации аппроксимация 
комментарий: комментарии 
панорамный: панорамные 
видный: видна 
незначительный: незначительная 
голос: голосов 
разработчик: разработчики 
какой: какого какую каких какие каком 
определённый: определенным определенную 
крутить: крутить 
вершина: вершинами вершине вершин 
куб: куб 
настройка: настройке настройка настройки 
добавить: добавлены добавить добавлена 
состояние: состоянию 
художник: художник художникам художника 
персонаж: персонаж 
посадка: посадке 
хитрость: хитростей 
образовать: образуют 
меню: меню 
связать: связан связаны 
наблюдатель: наблюдателя 
различный: различные 
ресурсозатратный: ресурсозатратнее 
миссия: миссии 
волюметрик: волюметриков 
вдаваться: вдаваясь 
описывать: описывает 
включая: включая 
упрощение: упрощение 
анизотропия: анизотропия анизотропии 
далее: д 
видеопамять: видеопамяти 
вид: видах виду виде видам видов вид 
подлететь: подлететь 
чистый: чистого 
часть: частях часть части 
глаз: глаза 
конкретно: конкретно 
любой: любое любую любая любой 
двухмерный: двухмерные двухмерную 
размер: размер 
обычный: обычную обычные обычным 
отдельный: отдельное отдельный отдельных 
строение: строения 
включать: включаю включающие 
синий: синего 
подразумевать: подразумевают 
небосклон: небосклона 
рядом: рядом 
высокий: высокая высоким высокие 
описать: описанных 
именно: именно 
поведение: поведение 
белый: белый 
часто: часто 
начать: начать начали 
покрывать: покрывать 
порядок: порядок 
базовый: базовый базовой базовых 
плотный: плотных 
генерировать: генерировать 
дело: деле дело 
нитевидный: нитевидную 
среда: среду среде среды 
восприятие: восприятия 
вырасти: выросли 
тень: тень 
альфа: альфа 
цвет: цвет цвета 
тексель: текселя 
марчинга: марчинга 
делаться: делается 
год: лет 
однако: однако 
точно: точно 
использовать: использовали использовать используем использован 
число: числе 
перезапуск: перезапуске 
помощь: помощью помощь помощи 
слой: слои слоя слоях слой 
рассмотреть: рассмотрим 
июнь: июне 
такой: такие такую такое такого таком таким такая таких 
попытаться: попытаться 
похожий: похожих похожие 
нужно: нужно 
видно: видно 
билборд: билбордами билбордов 
высота: высотой высотах высот высоте 
трёхканальный: трёхканальную 
техника: техника техник 
нижний: нижних нижней 
фото: фото 
пример: примеру примеры примерах примера 
отражение: отражений 
офлайновый: оффлайновой 
физика: физики 
динамика: динамики динамике 
иметь: имеют имеем иметь 
сгенерировать: сгенерированной сгенерировать сгенерировано 
статичный: статичная статичную 
граница: границы 
затратный: затратна 
плотность: плотность плотности 
сделать: сделать сделаны сделана 
подход: подход подходам подходе подходов подходы подходом 
генерироваться: генерируются 
параллельный: параллельного 
другой: другими другие других 
требоваться: требуется 
который: которые которым которая которых который которое котором 
кучевой: кучевые кучевых 
шаг: шаг шаге 
язык: языка язык 
метод: метод методов 
находиться: находится 
повторяться: повторяющиеся 
принятие: принятия 
буре: буре 
возможность: возможность возможности 
кубический: кубическая кубические кубической 
добиваться: добиваясь 
терять: теряет теряя 
дзен: дзен 
статья: статью статье статья 
заготовить: заготовленными 
итог: итоге 
категория: категории 
волюметрика: волюметрики волюметрика 
цель: целей 
вода: воды 
частично: частично 
плашка: плашек 
разный: разной разными разные разных разный 
корректно: корректно 
положительный: положительное 
относительно: относительно 
пролетать: пролетает 
малый: меньшая меньшем 
эффект: эффектах эффекта эффект 
старый: старым старую 
расположить: расположены 
снизу: снизу 
основный: основным основного 
посмотреть: посмотрим 
погода: погоду 
завязать: завязан 
чёрный: черного 
три: трех 
поиск: поиск 
зрение: зрения 
тот: те та ту 
монохроматический: монохроматического 
некий: некую 
геометрический: геометрических геометрический геометрические 
лишь: лишь 
существовать: существует существуют 
яркий: яркие 
давать: дающий давайте дает 
динамически: динамически 
вход: вход 
реализация: реализации 
карма: карма 
лишний: лишнего 
взгляд: взгляд взгляду 
движение: движении движения 
дополнительный: дополнительных дополнительную 
работа: работы работа 
нарезка: нарезки 
затянутый: затянутого 
полюбоваться: полюбуемся 
принцип: принцип 
оптимизация: оптимизации 
земля: земле 
вычисление: вычислений 
волюметрический: волюметрических волюметрическое волюметрические 
искажаться: искажаются 
несколько: несколько нескольких 
генерация: генерации 
пригодный: пригодные 
задаваться: задается задаваться 
компьютерный: компьютерных компьютерные 
импорт: импорте 
последовательность: последовательность 
мелкий: мельчайших помельче 
многослойность: многослойности 
обстановка: обстановку 
оправдать: оправдано 
искажение: искажений искажения 
решение: решений решения 
движок: движка движках движок движке 
настраивать: настраиваемые 
отвечать: отвечает 
изменить: изменить изменен 
гибкость: гибкость 
диапазон: диапазоне диапазоном 
кубмапе: кубмапе 
выбор: выбором 
необходимо: необходимо 
формообразование: формообразование 
серия: серии 
избежать: избежать 
закон: закон 
распространить: распространённых 
вполне: вполне 
профиль: профиль 
зависимость: зависимости 
безопасность: безопасность 
убивать: убивает 
рассеяние: рассеяние рассеяния 
подойти: подошла 
облако: облаками облака облаках облаков облако 
перистый: перистых перисто перистые 
деление: деление 
означать: означает 
ведьмак: ведьмак 
борт: бортом 
собирать: собирает 
постепенно: постепенно 
детальный: детальные 
смотреть: смотреть 
направить: направлены направленному 
зависеть: зависят 
уровень: уровне уровень уровнем 
изменяться: изменяющуюся изменяющиеся изменяющимся 
пробежаться: пробежимся 
возможный: возможное 
шейдинга: шейдинг 
детально: детально 
требовать: требуемых 
невозможно: невозможно 
значительно: значительно 
этот: этому эта этих 
бесшовный: бесшовные бесшовно 
скорость: скоростью 
технический: технического техническая технический технической 
сфера: сфере сферу 
создание: созданию создания 
увидеть: увидеть 
референсный: референсные 
фазовый: фазовая 
лёд: льда 
сторона: стороны сторону 
род: рода 
необходимый: необходимым 
многий: многих 
уходить: уходят 
условие: условия условиями условиях 
свет: света свет 
перспективный: перспективных 
хвостик: хвостик 
это: это 
подходить: подходят 
луч: лучей луч лучи 
принять: принято 
обойтись: обойтись 
заметить: заметить 
интервал: интервалов 
обратить: обратив 
объект: объектах объекте объект объекты объекта 
подвигать: подвигать 
высококучевой: высококучевые 
использование: использования использование 
тайлинга: тайлинга 
иллюзия: иллюзию 
каждый: каждое каждого каждом 
поддержка: поддержка 
охватывать: охватывающие 
кубмап: кубмапы кубмапам кубмап 
кривая: кривыми 
деталь: детали деталей 
вращаться: вращается 
делать: делаем 
надвижение: надвижения 
поместить: помещен поместить 
угодный: угодно 
запечь: запечь запечённая 
визуально: визуально 
реймарчинг: реймарчингом 
удобный: удобным 
геймплей: геймплей 
камень: камень 
множество: множество 
результат: результат результата 
референс: референсу референсы 
степень: степень 
взлёт: взлете 
создаваться: создается создаются 
позволять: позволяет 
переотражённый: переотраженных 
хаба: хабы 
рамка: рамках 
назначить: назначены 
прекрасный: прекрасные 
смысл: смысла 
обзорный: обзорную 
вышеперечисленный: вышеперечисленных вышеперечисленные 
отражённый: отражённый 
взять: взять возьмём 
создавать: создавать создаёт 
растеризация: растеризацией 
свобода: свободу 
близкий: ближе 
образ: образом 
треугольник: треугольников 
образование: образования 
прибавляться: прибавляется 
яркость: яркости 
внутри: внутри 
выглядеть: выглядит 
время: времени время 
формироваться: формируются 
реалтайм: реалтайме реалтайма 
пользователь: пользователь 
контраст: контраст контрасты контраста 
принимать: принимаемые 
сэмплировать: сэмплируя 
оперировать: оперировать 
название: названия названиях 
упаковать: упаковать 
замена: замену 
гистограмма: гистограмму 
освещение: освещения освещение освещением 
вырезать: вырезать вырезает 
аспект: аспектом 
нулевой: нулевое нулевых 
форма: формы форме форму форм форма 
координата: координаты 
погодный: погодные погодными 
считать: считаем 
проекция: проекций 
большинство: большинстве большинство 
верхний: верхних верхней 
этап: этапа этапов 
бер: бера 
взглянуть: взглянуть 
больший: большая больших большей большую большим больший 
план: плане 
ослабление: ослабление 
слишком: слишком 
мощность: мощностей мощности 
хотеть: хотим 
традиционный: традиционной 
становиться: становится 
обычно: обычно 
тег: теги 
соответствие: соответствие 
выяснить: выяснили 
октав: октавы 
кучево: кучево 
воображать: воображаемого 
уорлить: уорли 
выделить: выделить 
геометрия: геометрией геометрию геометрия 
атмосфера: атмосферы 
везде: везде 
ниже: ниже 
небосвод: небосводе 
ресурс: ресурсов 
слово: слову словами слово 
прочтение: прочтение 
участок: участках участок 
картинка: картинки картинка картинку 
например: например 
встречаться: встречаются встречается 
огромный: огромное 
углубиться: углубиться 
атлас: атлас 
прежде: прежде 
благодаря: благодаря 
грозовой: грозового 
арка: арки 
поэтому: поэтому 
усложнить: усложнённый 
максимально: максимально 
компания: компании 
ландшафт: ландшафта 
третий: третьем 
воздушный: воздушным воздушного 
левый: левом 
истребитель: истребителе 
составлять: составляющей 
сместить: сместить 
высокочастотный: высокочастотные высокочастотный 
винтокрылый: винтокрылого 
область: область областях 
заключение: заключении 
очень: очень 
пучок: пучка 
вокруг: вокруг 
повторять: повторяют 
быть: будь будут 
кстати: кстати 
небольшой: небольшой 
двумерный: двумерных 
объёмный: объёмные 
плюс: плюсы 
кроме: кроме 
барашек: барашки 
поглощать: поглощающей 
градиент: градиента градиенты 
человек: люди 
итак: итак 
срез: срезе 
карта: картой карта карты 
негативный: негативное 
развёртка: развертку 
исходить: исходя 
знать: знаем 
вертолёт: вертолета вертолеты 
самолёт: самолета самолеты 
некоторый: некоторых 
слегка: слегка 
нарезать: нарезанного 
корректный: корректным 
создать: создать 
муравский: муравского 
игрок: игрок 
указать: указать 
навык: навыков 
просто: просто 
добавлять: добавляет 
место: место 
проходить: проходят проходит 
полёт: полета полётами 
канал: канал канала 
распределить: распределить 
важно: важно 
всё: всё 
сэмплирование: сэмплирований сэмплирование 
прислать: пришли 
наш: наш нашему 
накладываться: накладываются 
жизнь: жизней 
амбиентный: амбиентного 
назад: назад 
одномоментный: одномоментно 
расстояние: расстоянием 
конус: конусу 
иметься: имеется 
версия: версию 
абсолютно: абсолютно 
вместо: вместо 
условно: условно 
экспонент: экспоненте 
реальный: реальном реального 
применяться: применяется 
использоваться: используются используется 
понять: понять 
известный: известных известный 
физический: физический 
инструмент: инструмента инструментов 
нарисовать: нарисовать 
окружающий: окружающий 
достоверный: достоверные 
преобразовывать: преобразовывать 
также: также 
писать: писали 
региональный: региональной 
предел: пределах 
менее: менее 
элемент: элементы элементов 
зато: зато 
выделять: выделять 
специальный: специальными 
поделить: поделить 
свидетельствовать: свидетельствует 
сцена: сцене 
бесплатный: бесплатную 
менять: менять меняют 
издание: изданиях 
наиболее: наиболее 
доклад: доклада 
околосимуляторный: околосимуляторных 
текстурный: текстурные 
файл: файла 
прямой: прямое прямого 
дисторсия: дисторсии 
мы: нам 
закономерность: закономерность 
прийтись: придется 
диспетчерская: диспетчерской 
дождевой: дождевые 
окружение: окружения окружение 
стилистика: стилистикой 
меняться: меняющееся 
средний: средний 
солнце: солнце солнца 
комментировать: комментировать 
параметр: параметры параметров параметр 
подразумеваться: подразумевается 
точка: точка точки 
важный: важная 
достаточно: достаточно 
процесс: процесс процесса 
градус: градусов 
перлином: перлином 
фронт: фронта 
смоделировать: смоделировать 
сэмплироваться: сэмплируется 
хороший: лучшие 
тип: типы типов 
новый: новые новый 
формирование: формирования 
вчера: вчера 
рваный: рваные 
игровой: игровой игрового 
они: ими ними 
формировать: формировать 
формат: форматах формата 
сайт: сайт 
информация: информацию информация 
слоистый: слоисто слоистые слоистых 
барашковый: барашков 
горизонтальный: горизонтальной 
попробовать: попробовать 
представить: представить 
скорый: скором 
транспорт: транспорта транспортом 
мина: мин 
говорить: говорит говорить 
отрендить: отрендить 
заяц: зайцев 
достижение: достижения 
длинный: длинные 
транскрипция: транскрипция 
способ: способов 
сгененрировать: сгененрировано 
суть: сути 
сутки: сутки 
структурированность: структурированности 
должный: должно 
лето: летом 
назначаться: назначалась назначаются 
дождь: дождь 
приходить: приходит 
добавляться: добавляются 
частотность: частотностью 
частица: частиц 
весь: всем всей 
готовый: готовое 
момент: моменте момент 
изменение: изменения 
хватать: хватало 
ограниченный: ограниченный ограниченном 
коэффициент: коэффициент 
выстрел: выстрелом 
появление: появление 
мир: мир миры 
вертикальный: вертикальной 
километр: километров 
выше: выше 
графика: графике графикой 
систематизировать: систематизировать 
турбулентность: турбулентности 
правило: правило 
пиксель: пикселя 
лужайка: лужайки 
куба: куба 
общепринятый: общепринятого 
рассматривать: рассматривать 
видеть: видит видим 
окно: окном 
затенить: затененных 
модулироваться: модулируется 
скайбокс: скайбоксом 
немного: немного 
вроде: вроде 
рейтинг: рейтинг 
визуализировать: визуализировать 
стул: стул 
ясный: ясную 
вконтакте: вконтакте 
далёкий: дальше 
разработка: разработка 
диспетчер: диспетчерам диспетчеры 
полностью: полностью 
зелёный: зеленой 
неплохой: неплохим 
отдельно: отдельно 
количество: количество количеством 
обзор: обзора 
называться: называется 
дополнительно: дополнительно 
равномерно: равномерно 
либо: либо 
заключаться: заключается 
юбка: юбке 
тема: тему 
довольно: довольно 
буквально: буквально 
закладка: закладки 
изначально: изначально 
простой: простой 
процедурный: процедурный процедурным 
др: др 
поспорить: поспорить 
сложить: сложенные 
вернуться: вернуться 
выражаться: выражается 
ламберт: ламберта 
текстурок: текстурка 
многие: многие 
подробно: подробно 
кристаллик: кристалликов 
себя: собой 
оправданный: оправданно 
смесь: смесь 
хабра: хабр 
сложность: сложности 
останавливаться: останавливаться 
реф: рефы 
открытый: открытые 
край: краям края 
возврат: возврата 
низ: низу 
бывать: бывают 
храниться: хранится 
распространяться: распространяться 
малозатратный: малозатратный 
обновить: обновить 
разобраться: разобраться 
маленький: маленькие 
ливень: ливне 
ползунок: ползунки 
вращение: вращением 
посредством: посредством 
бесконечный: бесконечный 
определять: определять определяющий 
состоять: состоят 
шагать: шагаем 
подаваться: подается 
логично: логично 
анизотропный: анизотропное 
заранее: заранее 
комбинированный: комбинированный 
набор: наборе набор 
обратный: обратное 
ось: оси 
поканальный: поканально 
просмотр: просмотров 
стоить: стоит 
публикация: публикации 
порог: пороги 
бенчмарка: бенчмарки 
энергия: энергию 
рандомный: рандомную 
так: т 
грань: граней 
соответствующий: соответствующих 
осадка: осадками 
переотражаться: переотражается 
поглощаться: поглощается 
пускать: пускаем 
физически: физически 
иван: ивана 
данный: данный 
вышка: вышки 
тысяча: тысяч тысячи 
сложный: сложнее 
объём: объема 
отличие: отличие 
право: правом 
распространение: распространении 
грубый: грубых 
бугера: бугера 
намеренно: намеренно 
состояться: состоявшегося 
интерпретировать: интерпретирует 
усреднить: усредненный 
экономия: экономии 
основное: основном 
способный: способны 
море: моря 
рассказывать: рассказываем 
собрать: собрать 
казаться: казалось 
метр: метров 
послойный: послойную 
рендить: рендить 
тёмный: темнее тёмный 
сказать: сказать 
случай: случае 
блог: блог 
присутствовать: присутствуют 
дорога: дорогой 
уникальный: уникальное 
влияние: влияние 
очевидный: очевидно 
перпендикулярно: перпендикулярно 
туман: туман 
основной: основные 
недавний: недавних 
управление: управлением 
разрешение: разрешении 
нюанс: нюансы 
высокослоистый: высокослоистые 
вместе: вместе 
вообще: вообще 
сквозь: сквозь 
появляться: появляться 
сначала: сначала 
захотеть: захотим 
облачность: облачности 
минус: минусы 
