рассылка: рассылки 
мочь: могут мог 
управление: управление 
прикладывать: прикладываю 
задача: задачи 
структура: структура 
клиент: клиентам клиентов клиенты 
прежний: прежнему 
приложение: приложения приложении приложение приложений 
косвенный: косвенные 
измеримый: измеримые 
пирамида: пирамиды пирамиду пирамида 
позволить: позволило 
свой: своего свой свои своем 
отделение: отделения 
задать: задать 
внедрить: внедрить 
облачный: облачные облачных 
влиять: влияет влиять 
любой: любого любым 
нефинансовый: нефинансовым нефинансовые нефинансовое нефинансовых 
презентация: презентацию презентации 
подойти: подошел 
нагрузка: нагрузкам 
внимание: внимание внимания 
выступление: выступление 
разработка: разработки разработке разработка разработку 
выбор: выбора выбор 
пользователь: пользователи пользователям пользователя пользователь пользователей пользователями пользователю пользователе 
актуальный: актуальным 
яндекс: яндекс 
выяснить: выяснила 
поскольку: поскольку 
технология: технологий технологии 
возможно: возможно 
долгосрочный: долгосрочная 
финансовый: финансовые финансовом финансовым финансовый 
сам: самого 
стоимость: стоимостью 
система: система 
признательный: признателен 
получать: получать получаете 
выделить: выделил выделить 
канал: каналов канал канала 
комментарий: комментарии комментариях 
аналитик: аналитики аналитике 
голос: голосов 
разрабатывать: разрабатывать 
обеспечение: обеспечение 
продукт: продуктом продуктов продукты продукту продукт продукте продукта 
лизинг: лизинг 
посвятить: посвящен посвящено посвящены 
мсб: мсб 
относиться: относятся 
меню: меню 
должный: должны должна 
страхование: страхование 
посмотреть: посмотреть 
внедрение: внедрения 
помимо: помимо 
функция: функции функций 
гипотеза: гипотезы гипотез 
пасхалка: пасхалки 
докладчик: докладчики 
связанный: связанные 
далее: д 
запрещать: запрещает 
требование: требованиям 
часть: часть 
митапа: митапа митап митапе 
квизов: квизов 
конкретно: конкретно 
машинный: машинного 
хелп: хелп 
зарегистрироваться: зарегистрироваться 
база: базе 
зрелый: зрелая 
увеличить: увеличить 
шаг: шагов 
общаться: общались 
прошлый: прошлой 
важный: важных важными важный важные 
именно: именно 
четыре: четырех 
выясниться: выяснилось 
экономить: экономить 
начать: начать начали 
код: коды код 
конкурентный: конкурентном конкурентных 
речь: речь 
приходить: приходите 
выбрать: выбранный выбрал выбрала 
лист: лист 
стратегия: стратегия стратегию стратегий 
запуск: запуск запуске 
альфа: альфа 
начинать: начинает 
добавить: добавить 
год: лет 
появиться: появился 
звонить: звонят 
однако: однако 
число: числе 
ответ: ответы 
опрос: опросы опросов 
помощь: помощью 
такой: такие такое такого такая таких 
уделить: уделила 
нужно: нужно 
юрий: юрий 
удержание: удержания 
голосовой: голосовых 
интегратор: интегратор 
что: чему 
хотеть: хотело хотели 
поговорить: поговорим 
выделять: выделяем 
вовлечение: вовлечение 
язык: языка язык 
который: которые которым которого 
взаимодействовать: взаимодействуют 
подробность: подробностей 
геймификация: геймификация 
требовать: требует 
киров: киров 
мобильный: мобильные мобильное мобильного мобильными 
применять: применяла 
определённый: определенными 
дзен: дзен 
мысль: мысли 
возможность: возможность 
вход: входа 
какой: какую какие 
итог: итоге итогам 
цель: целей 
платформенный: платформенные 
метод: методам 
финуслуга: финуслуги финуслуг 
рассказать: рассказала рассказал 
три: трех 
поиск: поиск 
мониторинг: мониторинга 
использовать: использовать 
доклад: доклад докладам доклады докладе доклада докладов докладу 
аспект: аспект 
аудит: аудит 
вершина: вершине 
собрать: собрал собрать 
сайт: сайте сайта сайт 
продажа: продажах продажи продаж 
заказ: заказы 
развиваться: развивалось 
карма: карма 
замкнуть: замкнуть 
интерфейсный: интерфейсные 
пушить: пуши пушей 
проект: проектах проектов проекте проекты 
результат: результате результат результата результаты 
работа: работы работа работе 
единый: единая 
кит: киту 
обучение: обучения 
архитектура: архитектуры архитектура 
электронный: электронный 
второй: второй 
построить: построить 
показать: показали 
оформить: оформить 
несколько: несколько 
баннер: баннеры 
причина: причинах 
участник: участниками участников 
консистентность: консистентность 
настройка: настройка 
тайм: тайм 
решение: решений решения 
привет: привет 
гибкость: гибкость 
персонализация: персонализация 
гибкий: гибкая гибкого гибкой 
метрика: метриками метрик метрике метрики 
поделиться: поделюсь поделился 
стать: статей стали стать 
избежать: избежать 
связь: связи связь 
ключевой: ключевых 
удобно: удобно 
профиль: профиль 
выбирать: выбирает выбирала 
грузоперевозка: грузоперевозки грузоперевозок 
быть: буду будем 
показатель: показателей показатели показатель 
правильно: правильно 
облако: облака облаке облако 
спикер: спикерам спикер 
смотреть: смотреть 
качество: качества качество 
уровень: уровне 
специфический: специфических 
надёжный: надежные надежна 
чат: чате 
согласно: согласно 
банк: банк банка банков 
ссылка: ссылки ссылкой ссылка 
весь: вся 
старый: старую 
выгодный: выгодные 
решить: решила решили 
генерировать: генерируем 
контрагент: контрагентов 
создание: созданию создании создание создания 
увидеть: увидеть 
условие: условия 
контент: контент 
рассказывать: рассказывала рассказываю 
это: это этим 
разный: разными 
применить: применить 
провести: провели 
обойтись: обойтись 
фреймворк: фреймворк 
иметь: имеет 
попасть: попасть 
изменять: изменяем 
эфир: эфире 
отвечать: отвечаю 
команда: команды команду команде команда 
каждый: каждое каждого каждые 
поддержка: поддержка 
включённость: включенность 
обзор: обзор 
осознать: осознаем 
квиза: квизы 
задавать: задавайте 
старт: старте 
успешность: успешности 
регистрироваться: регистрироваться регистрируются 
сегмент: сегмента сегментами сегменте 
циклично: циклично 
сервис: сервисами сервис сервисы 
потребность: потребностей потребности 
биржа: биржи биржа 
регистрация: регистрация регистрации 
телеграм: телеграм 
стек: стеком 
почему: почему 
сеть: сеть 
возникнуть: возникли 
дырма: дырма 
время: временем время 
позволять: позволяет позволяют 
очередь: очередь 
подписываться: подписывайтесь 
хаба: хабы хабе 
современный: современные 
повысить: повысить 
определять: определяем 
смысл: смысла 
ремонт: ремонту 
опыт: опыте опытом 
получиться: получилось 
заработать: заработать 
близкий: ближе 
соотносить: соотносимые 
звать: зовут 
внутри: внутри 
анкета: анкете 
вклад: вклады вкладов 
эксперт: экспертам экспертами экспертов 
финтех: финтех финтеху 
повышение: повышение 
бизнес: бизнеса бизнес 
прозвучать: прозвучало прозвучали 
идея: идеи 
нужный: нужна 
партнёрский: партнерская 
проблема: проблем проблемы 
инфраструктура: инфраструктуру инфраструктура 
обсудить: обсудили 
сфокусироваться: сфокусироваться 
избавляться: избавляемся 
подход: подходе подходов подхода 
нуль: нуля 
пользоваться: пользуются пользоваться 
изучить: изучили 
среди: среди 
достигнуть: достичь 
идти: идет 
дорабатывать: дорабатываем 
открывать: открывают 
следующий: следующим следующем 
понимать: понимаем 
тег: теги 
сторис: сторис 
документооборот: документооборот 
ниже: ниже 
госуслуга: госуслуги госуслуг 
ресурс: ресурсы ресурсов 
направить: направленных 
рада: рады 
млн: млн 
прочтение: прочтение 
например: например 
читать: читайте 
процесс: процессами процесс 
поэтому: поэтому 
заходить: заходят заходили 
алексей: алексей 
история: история 
максимально: максимально 
компания: компании компания 
реализация: реализацию 
статья: статье статьи 
первый: первый первую первым 
коммуникация: коммуникации 
повлиять: повлиять 
пасть: пал 
основание: основании 
вопрос: вопросы вопрос 
составлять: составляющей 
оформление: оформление оформления 
технологический: технологических 
усилить: усилить 
постараться: постараемся постараюсь 
ожидать: ожидать 
проверка: проверки проверку 
проходить: проходила 
оставить: оставите 
путь: путь 
виральность: виральность 
построение: построения 
управляемый: управляемой 
блок: блока 
привлекать: привлекать 
кстати: кстати 
цикл: цикл 
небольшой: небольшой 
помочь: помочь 
лидер: лидер 
крупный: крупные крупнейший 
чек: чек 
человек: люди 
лида: лиды 
запись: запись записи 
помощник: помощников 
вывод: выводы 
уязвимый: уязвимы 
онлайн: онлайн 
продуктовый: продуктовые продуктовом продуктовой продуктовая продуктовых 
найти: найдете найти 
магазин: магазины 
прочитать: прочитать прочитали 
железо: железо 
предпринимать: предпринимает 
создать: создать 
сегментный: сегментная сегментную 
тестирование: тестирования тестирование 
грамотный: грамотной 
устройство: устройства 
просто: просто 
конференция: конференции 
обратный: обратную 
телефон: телефона 
лена: лены 
законодательство: законодательство 
лояльность: лояльность лояльности 
подружить: подружить 
важно: важно 
всё: всё 
наш: наш наши нашем наша 
полезный: полезные 
потенциальный: потенциальным 
подробный: подробнее 
развитие: развитие 
затем: затем 
использование: использовании 
версия: версию версии 
вместо: вместо 
начинаться: начинается 
михаил: михаил 
ёмко: емко 
ускорять: ускоряют ускоряет 
понять: понять 
вели: вели 
соответствовать: соответствовать 
интерес: интерес 
трекер: трекеры 
также: также 
писать: писали писал 
запускать: запускали 
делать: делает 
переводить: переводите 
работать: работают работает работал работать работала 
сократить: сократить 
рынок: рынке рынка 
доступный: доступны 
кирпич: кирпичей 
реальный: реальный 
плюс: плюс 
московский: московской московская 
экран: экран 
главный: главный главные 
большинство: большинство 
мкб: мкб 
автотранспорт: автотранспорта 
цода: цоды 
тинькофф: тинькофф 
комментировать: комментировать 
номер: номеру 
обновлять: обновлять 
вариант: вариантами вариант 
точка: точка 
инструмент: инструменты инструментов 
мясо: мяса 
приём: приемов 
ответить: ответить 
исследование: исследованиям исследования 
осваивать: осваивают 
реалия: реалиях 
хороший: лучшие 
мгновенный: мгновенного 
больший: большие 
новый: новые новых 
вчера: вчера 
они: ими 
настроить: настроить 
отличный: отличную 
диджитал: диджитал 
изучать: изучать 
мой: мою 
транспорт: транспорта 
оба: оба 
мина: мин 
текст: текст 
состоять: состоит 
участвовать: участвовала 
веб: веб 
инвестиция: инвестиция 
недосуг: недосуг 
взаимодействие: взаимодействия 
холодное: холодные 
груз: груза 
смочь: сможете 
суть: сути 
сутки: сутки 
вести: ведут 
третий: третью 
п: п 
затрата: затрат 
отслеживать: отслеживать 
машина: машина 
звонок: звонки 
связать: связаны 
неделя: неделе 
допустить: допустить 
пункт: пунктов 
этап: этапов этапах 
робот: роботах 
маеркин: маеркина 
кейс: кейс 
этот: этих 
цифровой: цифровой 
эксперимент: эксперименты 
доступность: доступностью 
войти: вошло 
игра: игр 
выше: выше 
механик: механик 
таск: таск 
полтора: полтора 
масштабирование: масштабирования масштабирование 
речевой: речевой 
говорить: говорю 
светлана: светлана 
данные: данных 
авторизация: авторизация 
строительство: строительство 
фз: фз 
вовлекать: вовлекать 
вагнер: вагнер 
рейтинг: рейтинг 
россиянин: россиян 
выдвигать: выдвигаем 
другой: другие других 
два: двух 
направление: направления 
далёкий: дальше 
один: одной 
классификация: классификация 
быстрый: быстрой 
иерархия: иерархия 
технический: техническая технической 
гиперфокус: гиперфокуса 
остальной: остальные 
малое: малого 
мотивировать: мотивировать 
самостоятельно: самостоятельно 
количество: количество 
дело: делом 
подрядчик: подрядчиков 
пазл: пазлы 
подборка: подборку 
целевой: целевое 
поехать: поехали 
полноценный: полноценный 
развивать: развивать 
мироненков: мироненков 
просмотр: просмотра просмотров 
посвянский: посвянский 
увеличивать: увеличивают 
конспект: конспекты 
закладка: закладки 
цифра: цифры 
проверять: проверяем 
банковский: банковском банковских 
похожий: похожие 
вернуться: вернуться 
особый: особый особое 
измерить: измерить 
предполагать: предполагает 
привлечение: привлечения 
фокус: фокус 
подробно: подробно 
надёжность: надежностью 
осаго: осаго 
хабра: хабр 
впервые: впервые 
идентификация: идентификация 
видеть: видеть 
час: часа 
прямой: прямая 
алгоритм: алгоритм 
обновить: обновить 
оценка: оценка 
тот: той 
сохранить: сохранить 
доход: доход 
дать: данные 
конкуренция: конкуренция 
фича: фичей фичи 
ресегментация: ресегментация 
гибридный: гибридную 
нативный: нативную нативные 
елена: елена 
публикация: публикации 
никакой: никаких 
кредит: кредитов 
сильный: сильной 
так: т 
стор: сторах 
акцент: акцент 
набор: набор 
пример: примеров 
сравнимый: сравнимые 
среднее: среднего 
намного: намного 
заключение: заключения 
предпосылка: предпосылки 
способ: способами 
невозможный: невозможна 
уделять: уделяла 
фактически: фактически 
удерживать: удерживать 
действие: действие 
скорость: скорость 
самый: самые 
блог: блог 
готовность: готовность 
аудитория: аудиторией 
параллельно: параллельно 
основной: основные 
конкурент: конкуренты 
лояльный: лояльной 
интересный: интересны 
прибыль: прибыль 
расслабленность: расслабленности 
нюанс: нюансы 
владимир: владимир 
размещать: размещать 
вместе: вместе 
вообще: вообще 
особенность: особенности 
сумма: сумме 
кросс: кросс 
ниша: ниш 
тезис: тезис 
давать: дают 
прозрачный: прозрачные 
минус: минусы 
