логика: логика 
процесс: процессы процессами процессов процессах 
материал: материалов 
мочь: могут можем могу можете 
спринт: спринт спринтов спринта спринтами спринте спринтам 
управление: управление 
задача: задачи задаче задачу 
степень: степени 
различный: различных 
внедрить: внедрить 
ответ: ответ 
ряд: рядах ряд 
хороший: хорошим лучшие хорошая лучшему 
научиться: научиться научится 
шаг: шаги шагов шаг шагам шагами 
любой: любого любая любой любом 
путём: путем 
учитывать: учитывая 
подводить: подводя подводить 
действие: действия 
практиковать: практиковать 
свалиться: свалимся 
разработка: разработки разработкой разработке 
пользователь: пользователи пользователь пользователей 
яндекс: яндекс 
позиция: позиций 
коллега: коллег 
ошибка: ошибку 
плеяда: плеяда 
добиться: добиться 
посвятить: посвященных 
пойти: пойти 
дорогостоящий: дорогостоящих 
зарегистрировать: зарегистрированные 
участвовать: участвовать 
сам: самого самому сама 
итог: итоги итоге итог 
общий: общей общем 
обсудить: обсудите 
полный: полной 
совершить: совершить 
получать: получать 
знать: знаете знаю знает 
мастер: мастер мастера 
комментарий: комментарии 
голос: голосов 
разработчик: разработчики разработчик разработчиков 
оптимальный: оптимальным оптимальном 
перейти: перейти 
хотеть: хотел хотим хотели хочу 
неэффективный: неэффективное 
копирование: копирования 
масштабный: масштабных 
относиться: относятся 
меню: меню 
крупный: крупной крупную крупные 
тот: тому тех 
ставить: ставить 
внедрение: внедрения внедрении внедрению внедрение 
помимо: помимо 
команда: командой команды командах команде команд команда 
труд: труда 
понравиться: понравилась 
снижение: снижение 
обычный: обычную 
оказываться: оказываются 
проводиться: проводится 
важный: важных 
часто: часто 
начать: начать 
теряться: теряется 
эксперимент: экспериментов 
ориентация: ориентации 
мысль: мысль 
войти: войдите 
рассказывать: рассказывают рассказывала рассказывать 
свой: свой своих своей 
классический: классическому 
добавить: добавить 
мотивация: мотивацию 
мешать: мешают мешает 
интересоваться: интересующегося 
разарботка: разарботка 
однако: однако 
точно: точно 
пролистать: пролистать 
мелкий: мелких мелкие мелкими 
привнести: привнести 
формально: формально 
такой: такие такое такого таким 
видно: видно 
нужно: нужно 
эксперт: эксперт 
развитие: развитии 
понимать: понимают понимаю понимает 
энергия: энергия энергию 
ность: ности 
пожалуйста: пожалуйста 
получаться: получаются 
простой: проще простыми простой 
никто: никто 
сделать: сделать сделано 
подход: подход подхода подходы 
язык: языка язык 
этот: этими 
который: которые который 
сидеть: сидишь 
метод: метод 
учесть: учесть 
дзен: дзен 
возможность: возможность возможности 
продукт: продуктов продукт продукте продукта 
привлекательный: привлекательным 
считать: считаете считаю 
менять: меняя менять меняет 
результат: результатом результате результатами результат результатов результата результаты 
тестирование: тестированию 
первый: первые 
идеальный: идеального идеальном 
приходить: приходят приходит 
мой: моем моих моего моему 
бэклога: бэклог 
поиск: поиск 
целый: целый целая целую 
зрение: зрения 
путь: пути путь 
изменение: изменениям изменений изменения 
причина: причине 
существовать: существует 
воздержаться: воздержался 
подвести: подвести 
идея: идею идеи 
карма: карма 
отдача: отдача 
взгляд: взгляд 
тип: типа 
оперативно: оперативно 
адаптация: адаптации 
работа: работы работу работе 
отдать: отдать 
ситуация: ситуациях ситуации ситуацию 
задаваться: задается 
несколько: несколько 
проголосовать: проголосовали 
далее: далее 
приступать: приступая 
недавно: недавно 
проводить: проводим проводить 
заказчик: заказчикам 
проблема: проблема 
нравиться: нравится 
сегодня: сегодня 
настройка: настройка 
адаптировать: адаптировать адаптирует 
возникать: возникает 
быть: суть будут 
освоение: освоением 
профиль: профиль 
методология: методологию методологии 
зависимость: зависимости 
признаться: признаюсь 
означать: означает 
постепенно: постепенно 
идеология: идеологию идеология 
неправильно: неправильно 
смотреть: смотреть 
обухов: обухова 
уровень: уровне уровень 
прийти: пришедшие прийти 
маленький: маленьких мала 
препятствие: препятствиями 
основный: основными 
очный: очные 
ожидать: ожидаемых 
желание: желание 
познакомиться: познакомившись 
старый: старую 
скорректировать: скорректировать 
касаться: касается 
тематика: тематику 
психолог: психологом 
практика: практик практики практике практику 
высокий: высоком 
сфера: сфере сферы 
применение: применение 
коучить: коуча коучи 
опыт: опыта опыт опытом 
пополнять: пополнять 
он: нему 
отрицательный: отрицательный 
увидеть: увидеть 
наличие: наличие 
непонятно: непонятно 
инженер: инженер 
род: рода 
подумать: подумать 
это: это этим 
обойтись: обойтись 
непривычка: непривычки 
недовольный: недоволен 
требование: требований 
самый: самых 
этап: этапе 
принцип: принципы принципе 
поддержка: поддержка 
полномасштабный: полномасштабному 
делать: делаем делать делает 
постепенный: постепенного 
ответить: ответит 
текущий: текущей текущими текущем 
подойти: подойти 
применять: применяем применять 
функционал: функционал 
один: одном одной 
передать: передать 
показать: показать 
почему: почему 
множество: множество 
почитать: почитать 
меняться: меняться 
неделя: недели 
понимание: понимании понимание 
позволять: позволяет 
хаба: хабы 
должный: должен 
рамка: рамках 
модель: модель 
работать: работающем работаем работает 
сущность: сущности 
рабочий: рабочих 
перестройка: перестройки 
взять: взять 
образ: образом 
поговорить: поговорить 
звать: зовут 
специалист: специалистов 
время: времени время 
подчёркивать: подчеркивать 
основоположник: основоположники 
провал: провалов 
изначальный: изначальным 
успевать: успевает 
боязнь: боязнь 
сотрудник: сотрудники сотрудник 
организация: организация 
исключать: исключает 
надоесть: надоело 
целиком: целиком 
происходить: происходит 
гуру: гуру 
компания: компанию компании 
конец: конца 
больший: большая большей 
слишком: слишком 
трансформация: трансформаций трансформация 
готовый: готового готовы 
проверить: проверенным 
среди: среди 
сформировать: сформировать 
достигнуть: достичь 
объяснить: объяснить 
тег: теги 
погрузить: погруженного 
выделить: выделить 
стык: стыке 
теория: теории 
темп: темпов 
кратко: кратко 
прочтение: прочтение 
новый: нового новый 
встречаться: встречаются 
например: например 
н: н 
благодаря: благодаря 
куча: кучу 
поэтому: поэтому 
особенно: особенно 
производительность: производительности 
сильно: сильно 
собственный: собственного 
выполнимый: выполнимые 
трансформировать: трансформировать 
двигаться: двигаться 
профессионал: профессионалов 
снижать: снижая 
вопрос: вопросы вопрос вопросом 
форма: форму 
слово: словами 
заинтересованный: заинтересованный 
мнение: мнение мнения мнению 
лента: ленту 
просчитаться: просчитались 
очень: очень 
митинг: митинге 
хабра: хабра хабр 
каждый: каждого каждом каждый 
встреча: встречи 
ся: ся 
привести: привести 
отчётность: отчетности 
плюс: плюсы 
кроме: кроме 
разный: разных 
человек: люди человек 
бывать: бывает 
вывод: выводы 
польза: пользу 
приводить: приводит 
действительно: действительно 
день: день 
длина: длины 
широко: широко 
появляться: появляется 
концепция: концепции 
просто: просто 
переставать: перестает 
махровый: махровым 
инструкция: инструкции 
байка: байка 
практический: практические практическим 
важно: важно 
выполнение: выполнения 
член: члены 
смысл: смысле 
казаться: кажется казалось 
рекомендация: рекомендациям 
подопытный: подопытных подопытные 
версия: версию 
лицо: лица 
найтись: найдется 
искусство: искусство 
михаил: михаил 
оценка: оценки 
понять: понять 
какой: каким какие каком 
вызвать: вызванное 
также: также 
неизбежно: неизбежно 
позитивный: позитивный 
превратить: превратить 
менее: менее 
авторизовать: авторизовать 
мы: нам 
вовлечь: вовлечены 
история: истории 
киберпротект: киберпротект 
сталкиваться: сталкивался 
трёхлетний: трехлетнего 
съедать: съедает 
тинькофф: тинькофф 
оставаться: остается 
пилить: пилю 
комментировать: комментировать 
точка: точка 
продвигаться: продвигаться 
интуитивно: интуитивно 
достаточно: достаточно 
негативный: негативный 
донести: донесли 
действовать: действовать 
короткий: короткими коротких 
удаться: удалось 
штат: штат 
долгополов: долгополов 
пусть: пусть 
вчера: вчера 
подгонка: подгонки 
следовать: следует 
интересный: интересные 
выполнять: выполняя 
отразить: отразить 
недавний: недавнего 
следующий: следующем 
сайт: сайт 
думать: думаешь 
учиться: учиться 
ненужный: ненужное 
мина: мин 
говорить: говорит 
достижение: достижения 
взаимодействие: взаимодействия 
затевать: затевая 
сутки: сутки 
формат: форматов 
тяжело: тяжело 
резервный: резервного 
приступить: приступить 
брать: брать 
сложный: сложные 
соответствие: соответствии 
отслеживать: отслеживать 
иначе: иначе 
правило: правил 
нужный: нужен 
пункт: пунктов 
допустить: допустить 
повседневный: повседневных 
полгода: полгода 
проанализировать: проанализировать 
убедиться: убедиться 
планирование: планирования 
гулять: гуляет 
авторизация: авторизация 
начинать: начинают 
видеть: видит 
декомпозиция: декомпозиция 
плотный: плотного 
теоретик: теоретики 
пытаться: пытался 
коучий: коуч 
рейтинг: рейтинг 
вы: вами 
вконтакте: вконтакте 
далёкий: дальше 
движение: движения 
сказать: скажу 
последний: последних 
сложно: сложно 
видение: видением 
полезный: полезных полезны 
технический: техническая 
полностью: полностью 
отсутствие: отсутствие 
выстроить: выстроить 
обладать: обладает 
элемент: элементов элементами 
оценить: оценить 
самостоятельно: самостоятельно 
количество: количество 
производство: производства 
дть: демо 
принести: принес 
найти: найти 
забывать: забывать 
пошаговый: пошаговые 
опрос: опросе 
процедура: процедуры 
анна: анна 
качественный: качественным 
дальнейший: дальнейшего 
неплохо: неплохо 
закладка: закладки 
понадобиться: понадобится 
приём: приемы 
похожий: похожие 
вернуться: вернуться 
позвать: позвать 
честно: честно 
себя: собой 
мягкий: мягкую 
перестраивать: перестраивать 
верно: верно 
завтра: завтра 
внедрять: внедрять 
таки: таки 
сложность: сложности 
выполнить: выполнить 
главное: главное 
решить: решит 
вариация: вариации 
неприемлемый: неприемлемо 
сломать: сломали 
забыть: забыть 
позволить: позволит 
прозрачный: прозрачной 
обновить: обновить 
разобраться: разобраться 
принять: принять 
два: две 
минимум: минимум 
разбивать: разбивать 
немало: немало 
код: коде 
стоить: стоит 
просмотр: просмотров 
умение: умению 
публикация: публикации 
так: т 
непонимание: непонимания 
поделиться: поделиться 
копьё: копья 
прогресс: прогресс 
намного: намного 
пост: посте 
модернизировать: модернизирует 
главный: главным 
наоборот: наоборот 
координировать: координировать 
фактически: фактически 
дейли: дейли 
кодить: кодить 
общение: общения 
фокусировка: фокусировка 
строгий: строгом 
рельс: рельсы 
ретро: ретро 
изменить: изменить 
попытка: попытке 
случай: случае 
блог: блог 
чудовищный: чудовищных 
довольный: довольным 
приглашать: приглашая 
ежедневный: ежедневные 
тема: теме 
заинтересовать: заинтересованы 
сторона: сторон 
вместе: вместе 
вообще: вообще 
сначала: сначала 
противный: противном 
система: систем 
помогать: помогают 
водопадный: водопадную 
