описать: описано 
выше: выше 
быть: будем 
говорить: говорят 
скрипт: скрипта скрипте скриптов скрипты 
сорри: сорри 
калькулятор: калькулятор калькулятора 
обилие: обилие 
системный: системный 
удобно: удобно 
забытый: забыта забыт 
пойти: пошло 
профиль: профиль 
разумеется: разумеется 
понять: поняли 
ошибка: ошибки 
облако: облака 
плохо: плохо 
отлаживать: отлаживать 
рейтинг: рейтинг 
каждый: каждый каждой 
версионирование: версионирование 
давно: давно 
день: день 
один: одного одну одним 
спустя: спустя 
яндекс: яндекс 
сколько: сколько 
технология: технологий 
технический: техническая 
казать: кажет 
деньга: деньги 
запутаться: запутаться 
потреблять: потребляет 
запускать: запускать 
старый: старую 
количество: количество 
знакомый: знакомой 
просто: просто 
кухня: кухню 
называться: называется 
этот: этому 
настраивать: настраивать 
клавиша: клавиш 
вытягивать: вытягивает 
система: система 
масштабировать: масштабировано 
инструкция: инструкции 
круто: круто 
комментарий: комментарии 
важно: важно 
он: нему 
новый: новому новую 
голос: голосов 
тема: тему 
раковый: раковая 
назад: назад 
пять: пять 
появиться: появились 
закладка: закладки 
простой: простой 
версия: версию 
инженер: инженер 
хотя: хотя 
версионность: версионность 
отдел: отделе 
никто: никого 
действие: действий 
тёмный: темную 
дмитрий: дмитрий 
молодость: молодости 
меню: меню 
конфигурация: конфигураций 
сверху: сверху 
научный: научный 
похожий: похожие 
вернуться: вернуться 
это: это 
написать: написали написать 
представить: представьте 
месяц: месяце 
вживую: вживую 
серверный: серверное 
превратиться: превратился 
хабра: хабр 
любой: любое 
шлифануть: шлифануть 
мочь: мог 
работа: работа работы 
вакансия: вакансий вакансии 
сложность: сложности 
ручной: ручной 
привыкать: привыкать 
рядом: рядом 
спираль: спираль 
редактор: редактор 
правда: правда 
существовать: существуют 
поддержка: поддержка 
администрирование: администрирование 
который: который которое которая 
храниться: хранится 
момент: моменту 
начало: начале 
обновление: обновлений 
перфокарта: перфокартах 
обновить: обновить 
файл: файлы файлах файлов 
писать: писал писать 
проверить: проверить 
хранить: хранить 
главный: главный 
история: истории 
время: время 
почему: почему 
логично: логично 
добавить: добавить 
язык: язык языка 
перенос: перенос 
точно: точно 
хаба: хабы 
значит: значит 
сам: самом 
другой: другое 
прогон: прогоном 
самосбываться: самосбывающееся 
делать: делал делать 
такой: такие 
приходиться: приходилось 
просмотр: просмотров 
ввести: ввести 
девелопер: девелопера 
опухоль: опухоль 
публикация: публикации 
настройка: настройка 
считать: считать 
человек: человека человеку 
жизнь: жизнь 
минута: минут 
улучшательство: улучшательства 
вызывать: вызывали 
задумываться: задумывались 
ребята: ребята 
получать: получаем 
хороший: лучшие 
переключать: переключать 
вещь: вещь 
пусть: пусть 
усложнять: усложнять 
идея: идея 
первоначальный: первоначальная первоначального 
утащить: утащила 
дзен: дзен 
место: мест места 
команда: команда 
облегчать: облегчать 
создавать: создаем 
сайт: сайт 
экономить: экономите 
последний: последнюю 
наоборот: наоборот 
извинить: извините 
популярно: популярно 
хитро: хитро 
паблишить: паблишила 
мина: мин 
поиск: поиск 
слишком: слишком 
среди: среди 
хотеть: хотим 
понятие: понятие 
снова: снова 
забыть: забыл 
тег: теги 
думать: думали 
карма: карма 
вид: вид 
поместить: поместить 
сутки: сутки 
ползучий: ползучего 
вникать: вникать 
уровень: уровень 
фирма: фирмы 
ресурс: ресурсов 
прочтение: прочтение 
строчка: строчку 
пророчество: пророчество 
современный: современный 
час: часов 
принцип: принцип 
выполнять: выполняет 
наверное: наверное 
крутиться: крутилось 
весь: всем 
поэтому: поэтому 
изменить: изменив 
администратор: администратор 
интересовать: интересует 
несколько: несколько 
чтиво: чтиво 
нужный: нужен 
отладка: отладке 
пункт: пунктов 
работать: работал 
условие: условий 
расположение: расположение 
раскручиваться: раскручиваясь 
мнение: мнение 
