стандартизация: стандартизацией 
мочь: могут могли можете 
проектный: проектном проектный 
типоразмер: типоразмера 
свой: своего свой свои своих своим 
мгту: мгту 
большой: большой большом 
полезный: полезную 
понять: поняли 
незанятый: незанятого 
узел: узла 
стандартный: стандартного стандартные 
тонкоплёночный: тонкоплёночных 
давно: давно 
один: одного 
разработка: разработки разработка 
яндекс: яндекс 
коллега: коллег коллеги 
кубсат: кубсат кубсатов 
нужный: нужны 
технология: технологий 
получиться: получится получился 
классический: классическое 
рассказать: рассказать 
запустить: запущенные 
сам: самого 
начинка: начинка 
комментарий: комментарии 
голос: голосов 
передать: передан 
продиктовать: продиктован 
запланировать: запланированные запланирована 
бауман: баумана 
меню: меню 
торцевой: торцевыми 
маленький: маленького поменьше маленькие 
помимо: помимо 
миссия: миссии 
май: мая 
испытание: испытаний испытания 
команда: командой 
неизвестно: неизвестно 
часть: часть части 
панель: панелей панелями панель панели 
унификация: унификации 
размер: размер размером размера 
другой: другим другие другое 
черта: чертах 
терпеться: терпится 
рядом: рядом 
нагрузка: нагрузку 
кубик: кубиках кубика 
именно: именно 
часто: часто 
эксперимент: экспериментов 
ячейка: ячеек 
изменение: изменению изменение 
прогресс: прогрессе 
защитный: защитного 
составной: составная составные 
добавить: добавить 
тайнисат: тайнисат тайнисатов тайнисата тайнисаты 
использовать: использовали 
оказаться: оказались 
частый: чаще 
такой: такие таких 
недаром: недаром 
нужно: нужно 
техника: техника 
подойти: подошли 
иметь: имеют 
эпоксидный: эпоксидной 
пусковой: пусковую 
космос: космос 
справа: справа 
равно: равно 
вид: виде 
конкретика: конкретику 
расположить: расположен 
язык: языка язык 
который: которые которой которая которую 
переделка: переделку 
дзен: дзен 
пуск: пуска 
итог: итоге 
эдельвейс: эдельвейс 
гарантия: гарантий 
электроника: электроники 
обстоятельство: обстоятельства 
наш: нашим нашего наш наши нашем 
сервер: сервер сервера 
инженерный: инженерная инженерного 
поиск: поиск поисках 
тот: те та 
смотреть: см смотреть смотрели 
подходящий: подходящего 
однозначно: однозначно 
рассчитывать: рассчитывали 
унифицировать: унифицировать 
прогнозировать: прогнозируемый 
полететь: полетит 
полёт: полёт 
карма: карма 
отсмотреть: отсмотрели 
ждать: ждите 
проект: проектах проект проекте 
результат: результате 
работа: работы 
диод: диода 
солнечный: солнечные солнечный солнечного солнечных солнечная 
прошедшее: прошедших 
подложка: подложке 
показать: показали показать 
несколько: несколько 
интерес: интересах 
остаться: оставшиеся 
кристалл: кристалле 
проблема: проблема 
космический: космическая космический космического космические космических космическом 
установить: установлены установить 
настройка: настройка 
сей: сих 
место: места 
научно: научно 
профиль: профиль 
разумеется: разумеется 
сформировать: сформирован 
ств: ств 
образец: образец 
конструкция: конструкции 
начало: начала 
научный: научных научным 
облик: облик облике 
делиться: делятся 
блин: блинов блины блин блинами 
родиться: родилась 
старый: старую 
предыдущий: предыдущей 
планирование: планирование 
обнаружиться: обнаружились 
общий: общих 
закупать: закупали 
отгружать: отгружают 
создание: созданию создание 
космонавтика: космонавтика 
методология: методологии 
россия: россии россию 
аппарат: аппаратах аппарат аппарата 
собирать: собираем 
очередной: очередного очередную 
сбор: сборе 
это: это 
принять: принято 
провести: провели 
разрезать: разрезаны разрезать 
называть: называем 
поддержка: поддержка 
опытно: опытно 
спутник: спутник спутники спутника спутников 
слово: слове 
тестовый: тестовые 
объединять: объединяют 
какой: какое 
фэп: фэпы 
плита: плиты 
премия: премии 
пространство: пространстве 
видеть: видите 
текущий: текущий 
опытный: опытный 
пико: пико 
хаба: хабы 
код: коду 
похожий: похожи похожего похожа похожие 
гибкий: гибкие 
близкий: ближе 
покрытие: покрытия 
выглядеть: выглядит 
шасси: шасси 
время: времени время 
пользователь: пользователь 
прототипирование: прототипирование 
нормативный: нормативной 
ещё: ещё 
поставка: поставки 
подходить: подходили 
текстолитовый: текстолитовой 
составить: составят 
толщина: толщины толщине 
модуль: модули модулей 
считать: считаем 
больший: большая 
элемент: элемента элемент элементы элементов 
изыскание: изыскания 
срок: сроках 
среди: среди 
уверенно: уверенно 
тег: теги 
половинка: половинки 
программист: программисты 
санкт: санкт 
уровень: уровень 
дата: датой 
прочтение: прочтение 
типоряд: типоряду типоряд 
месяц: месяца 
например: например 
благодаря: благодаря 
алиэкспресс: алиэкспресс 
поэтому: поэтому 
возникнуть: возникла 
напечь: напечь 
компания: компании компания 
делать: делать 
образовательный: образовательных 
статья: статье статьи 
первый: первый первой 
центр: центр 
нагрев: нагрев 
сохраняться: сохраняется 
система: системы систем 
стандарт: стандарта 
начать: начали 
очень: очень 
запуск: запуска 
конец: конец концу 
зарубежный: зарубежных 
привести: привести 
данный: данном 
публикация: публикаций публикации 
получить: получить получили 
поставщик: поставщиков 
слева: слева 
действительно: действительно 
рассматривать: рассматривали 
переслать: перешли 
рф: рф 
сколько: сколько 
водопад: водопадом водопад 
ингредиент: ингредиентов 
пополам: пополам 
прототип: прототип 
просто: просто 
производство: производство производства производству 
телек: телеком 
состав: состав 
серийный: серийной 
всё: всё 
развитие: развитие 
надёжный: надёжный 
познакомить: познакомили 
версия: версию 
голосовать: голосуй 
покет: покеты 
продолжение: продолжения 
также: также 
писать: писали писать 
недостаточно: недостаточно 
запускать: запускали 
конструктивно: конструктивно 
сложность: сложность сложности 
послать: пошли 
этот: эта этих 
мы: нам 
большинство: большинство 
подбор: подбору 
цода: цоды 
программа: программе 
средний: средний 
некоторый: некоторые 
ставить: ставят 
длинный: длиннее 
стать: стала стать 
процесс: процесс 
практически: практически 
вариант: варианты 
хороший: лучшие лучшем 
вводный: вводном 
уверить: уверены 
вчера: вчера 
ранее: ранее 
исследовательский: исследовательской 
помощь: помощь 
документация: документации 
дело: дело 
мина: мин 
решение: решение 
гнёт: гнётом 
петербург: петербурге 
прийти: пришла 
отправиться: отправятся 
кампания: кампанию 
работать: работает 
всякий: всяких 
сутки: сутки 
открыться: открывшиеся 
унаследовать: унаследовали 
самый: самая 
дедлайн: дедлайны 
конструкторский: конструкторская 
занять: займёт 
новый: новых 
расчёт: расчёта 
остальной: остального 
сказать: сказано сказать 
малый: малые малых 
разработать: разработать 
разработчик: разработчиков 
итерация: итерацию 
слой: слоем 
рисунок: рисунок 
производить: производит производят 
рейтинг: рейтинг 
тысячный: тысячный 
ниокр: ниокр 
каждый: каждый 
вконтакте: вконтакте 
диктовать: диктуют 
путаться: путаться 
далёкий: дальше 
весь: всей всём 
технический: техническая технический 
сложно: сложно 
полностью: полностью 
отдельно: отдельно 
поменяться: поменяется 
долг: долгом 
способ: способом 
количество: количество количестве 
хостинг: хостинг 
пока: пока 
скидка: скидка 
найти: найти 
покеткуб: покеткубы 
исследование: исследованием 
гораздо: гораздо 
довольно: довольно 
проектирование: проектирования 
закладка: закладки 
пора: пор 
окр: окр 
вернуться: вернуться 
кубсата: кубсаты 
хабра: хабр 
сразу: сразу 
момент: момент 
спираль: спираль 
вновь: вновь 
ярить: ярило 
обновить: обновить 
популярный: популярного 
деятельность: деятельности 
вариативность: вариативность 
стартап: стартапа 
подозрительный: подозрительные 
печь: печёте 
дожидаться: дожидаемся 
просмотр: просмотров 
производитель: производителем 
серия: серию 
заинтересовать: заинтересовал 
читатель: читателям 
нюанс: нюанс 
менять: меняют 
стратосатый: стратосат 
отличие: отличие 
платформа: платформу 
отказаться: отказались 
смола: смолы 
тк: тк 
напомнить: напомню 
отечественный: отечественных 
логика: логику 
случай: случае 
блог: блог 
треугольник: треугольника 
январь: января 
купить: купить 
конфигурация: конфигурации 
установка: установки 
вместе: вместе 
появляться: появляться 
описать: описана 
