пересекать: пересекающие 
задача: задачи задач задаче 
реализовать: реализовать 
существенный: существенный 
различный: различных 
перевод: перевода переводов перевод переводу 
путём: путем 
идентичный: идентичные 
давно: давно 
один: одного одну 
яндекс: яндекс 
мой: моей 
корпус: корпусов корпуса корпусом корпусе корпус 
датасет: датасет датасете датасета 
последний: последнем 
анализ: анализа 
словарь: словаре 
полный: полной 
знать: знаете 
комментарий: комментарии комментариях 
голос: голосов 
разработчик: разработчики 
хотеть: хотел 
прогнать: прогнал 
меню: меню 
функция: функции 
английский: английского английским английский 
улучшение: улучшению 
статья: статьей статье статьи 
библиотека: библиотеку библиотеки 
машинный: машинного машинному машинный машинное 
дать: данная данной данные 
эмбеддинг: эмбеддингов 
прошлый: прошлой 
существенно: существенно 
свой: свой своих своей 
добавить: добавить 
сам: самой 
опубликовать: опубликовал опубликованном 
однако: однако 
помощь: помощью 
такой: такие такую такого 
перефразировать: перефразированную 
приложение: приложении 
простой: проще 
сравнение: сравнения 
пример: примерами примере пример 
отсутствовать: отсутствует 
язык: языка языками языках языком языков язык 
требоваться: требуется 
другой: другими 
который: которые который которую котором 
метод: метод 
внимание: вниманию 
дзен: дзен 
итог: итоге 
специально: специально 
поиск: поиск 
качество: качеству качества качестве качество 
познакомиться: познакомится 
переводчик: переводчик переводчике 
использовать: использовать использовал 
собрать: собрал 
предобученный: предобученные предобученными 
вес: весами веса 
китайский: китайских китайский китайского 
карма: карма 
показать: показав показали 
проект: проектах 
русский: русского русских русский 
результат: результате результатов 
популярный: популярной 
работа: работы работу работа работе 
обучение: обучения обучение 
данные: данным данных 
китайско: китайско 
поделиться: поделится 
предложение: предложений предложения 
скачать: скачать 
настройка: настройка 
профиль: профиль 
быть: буду 
получить: полученным получим 
параллельный: параллельных 
оценка: оценку оценки оценка 
любой: любым любую 
плохо: плохо 
официальный: официальный 
мочь: можем могли можете 
утробин: утробин 
присылать: присылайте 
прорыв: прорыв 
код: кода код 
стать: стал стало 
старый: старую 
выложить: выложена 
невозможно: невозможно 
предыдущий: предыдущей 
обученный: обученная 
личка: личку 
её: её 
качественный: качественной 
сжатие: сжатия 
токен: токены токенов 
это: это 
использование: использования использованием 
новость: новости 
поддержка: поддержка 
произвести: произведен произвел 
переводить: переводит переводят переводить 
обучить: обучить обучены 
текущий: текущий 
первый: первая первую 
тема: тема 
позволять: позволяет 
очередь: очередь 
хаба: хабы 
модель: модель моделей модели моделью 
получиться: получилось получился 
обратно: обратно 
хороший: хороший лучшие 
список: список 
я: мною 
парный: парных 
похуделый: похудела 
идея: идеи идеям 
сайт: сайта 
метрика: метрику метрикам 
нуль: нуля 
среди: среди 
битекст: битекстов 
взять: взял 
дообучение: дообучения 
выкладывать: выкладываю 
тег: теги 
лицензия: лицензия 
млн: млн 
прочтение: прочтение 
обгонять: обгоняет 
поэтому: поэтому 
продолжить: продолжить 
легко: легко 
качественно: качественно 
инструкция: инструкцию инструкции 
очень: очень 
сжать: сжал 
рад: рад 
размер: размеров 
кроме: кроме 
перефразирование: перефразирования 
основа: основу основе 
русско: русско 
вывод: выводы 
создаваться: создавалась 
вопрос: вопросе 
гигабайт: гигабайт 
оценивать: оценивать 
таковой: таковой 
создать: создать 
выход: выхода 
исходный: исходных 
браузер: браузере 
текст: текстов текста 
затем: затем 
версия: версию 
обучать: обучать обучал 
михаил: михаил 
способный: способные 
причём: причем 
известный: известные 
представлять: представляю 
архитектура: архитектурой архитектуру 
общий: общем общий 
также: также 
цель: целях 
заявлять: заявлял 
иметься: имеющихся 
необходимый: необходима 
бесплатный: бесплатную бесплатная 
интеллект: интеллект 
история: истории 
оставаться: остается 
слой: слоях слое 
найти: нашел найти 
достаточно: достаточно 
нейросеть: нейросети 
практически: практически 
прийтись: пришлось 
хотеться: хотелось 
ранее: ранее 
лишний: лишних 
реальный: реальной 
информация: информацию 
представить: представлено 
мина: мин 
удаление: удаления 
пара: пара 
сутки: сутки 
колонка: колонке 
оказаться: оказалась 
просканировать: просканировано 
большой: большое 
производиться: производилось 
актуальный: актуальной 
изменение: изменения 
кейс: кейс 
батч: батчей 
вакансия: вакансии вакансий 
провести: проведенного 
искусственный: искусственный 
немного: немного 
вроде: вроде 
рейтинг: рейтинг 
перевести: переведенные 
подготовить: подготовить 
слово: слов 
доступ: доступ 
быстрый: быстрой 
введение: введение 
улучшить: улучшить 
сложно: сложно 
технический: техническая 
полностью: полностью 
весь: всеми 
миллисекунда: миллисекундах 
самостоятельно: самостоятельно 
сравнить: сравнил 
количество: количество 
репозиторий: репозиторий 
пока: пока 
либо: либо 
появиться: появились 
закладка: закладки 
изначально: изначально 
заметить: заметил 
похожий: похожие 
вернуться: вернуться 
коммерческий: коммерческих 
интернет: интернете 
хабра: хабр 
производительность: производительность 
сразу: сразу 
момент: момент 
обновить: обновить 
пригодиться: пригодятся 
писать: писал 
надеяться: надеюсь 
два: две 
использоваться: используется 
время: время 
просмотр: просмотров 
публикация: публикации 
решение: решения 
второй: вторая 
наглядность: наглядности 
х: х 
тысяча: тысяч 
намного: намного 
присутствовать: присутствовали 
сложный: сложнее 
уменьшиться: уменьшилось 
мир: мира 
диск: диска 
ваш: вашему 
мультиязычный: мультиязычные 
включить: включили 
новый: новый 
мара: мар 
решить: решил 
сначала: сначала 
скорость: скорости 
