существо: существ существу 
здоровый: здоровой 
мочь: могут 
ефремов: ефремова 
обозначить: обозначат обозначена обозначили 
женщина: женщину 
автоматизированный: автоматизированная 
жёсткость: жесткость 
воспроизводство: воспроизводства 
первопричина: первопричиной первопричину 
материал: материалов материал материалы 
игра: игры игре 
дейгин: дейгин 
проработка: проработка 
объединиться: объединившихся 
ответ: ответ ответов 
поддерживать: поддерживать 
продление: продление 
являться: является 
клетка: клетки клеток клетках 
герасимов: герасимов 
стариться: стариться 
поперечный: поперечные 
конечный: конечных 
философ: философа 
давно: давно 
художественный: художественное 
определённый: определённом 
молодой: молодого молодому 
человеческий: человеческого 
земной: земные 
внешний: внешней внешних 
заинтересованный: заинтересованных 
пользователь: пользователи пользователя пользователей 
яндекс: яндекс 
добиться: добиться 
одряхлелый: одряхлел 
заморозить: заморозить 
возможно: возможно 
зарегистрировать: зарегистрированные 
смертность: смертность 
будущее: будущем будущее будущего 
срок: срока сроке 
пример: примером пример 
развитой: развиты 
средство: средств средство 
сила: сил силой силы 
возраст: возрастом возрасте возраста 
исследование: исследований исследования 
участвовать: участвовать 
система: система системы систему системам 
анализ: анализа 
интеллектуальный: интеллектуальное интеллектуальная интеллектуального 
усложнение: усложнения 
усовершенствование: усовершенствования 
чудовищный: чудовищного 
китовый: китовые 
матрикс: матрикса матриксе 
сильный: сильными 
комментарий: комментарии комментариях 
голос: голосов 
какой: какого какое каких 
чистый: чище 
страдание: страданья страдание страдания 
состояние: состоянию состояние состоянии 
молодость: молодости молодость 
меню: меню 
выдающийся: выдающегося 
планета: планеты 
должный: должны должна должен должно 
тот: тому тех той 
различный: различные различными 
упомянуть: упомянем 
ранний: ранний 
включая: включая 
оказывать: оказывать оказывают 
теоретически: теоретически 
исследователь: исследователям 
биохакер: биохакеров 
целесообразно: целесообразно 
далее: д далее 
фёдоров: фёдоров 
смерть: смерти смерть 
прикладной: прикладные 
омоложение: омоложение 
обусловить: обусловлено обусловленный обусловленного 
наступление: наступления 
вредный: вредные 
старение: старением старения старение 
механизм: механизмы механизма механизм механизмов 
единица: единиц 
безопасность: безопасности 
бороться: бороться борется 
конкретный: конкретным 
утверждать: утверждает 
правда: правда 
подсказывать: подсказывая 
временной: временная 
именно: именно 
косвенно: косвенно 
природа: природой природа природы 
живой: живых живом живые 
войти: войдите 
порядок: порядка 
быть: будучи суть будем будут 
рб: рб 
умерший: умершую 
добавить: добавить 
цитата: цитат 
перенос: перенос переноса 
год: лет года 
однако: однако 
неистовый: неистово 
частый: чаще 
помощь: помощью 
нужно: нужно 
проблема: проблему проблемы 
осознавать: осознаёт 
слабый: слабых 
юрий: юрий 
пожалуйста: пожалуйста 
ирис: ирис 
вид: виде 
гликирование: гликирования 
мера: мера мере 
отказываться: отказываясь отказываемся 
язык: языка язык 
судьба: судьбы 
который: которые которым которая которых который которое котором 
изначальный: изначальному изначальном изначальный 
осуществить: осуществлена 
предложить: предложит 
переступание: переступания 
дзен: дзен 
ткань: тканей ткани 
индивид: индивида 
клатратный: клатратную клатратной 
продукт: продуктов 
статья: статью статье статья 
жена: жену 
автор: авторы 
деградировать: деградировать деградируют 
гарантия: гарантий гарантия 
белковый: белковые 
считать: считаете считаем 
надеяться: надеемся 
развитие: развития 
период: периода 
информационно: информационно 
планировать: планируем 
налаживать: налаживать 
масштабный: масштабный 
путь: пути путей путь 
поиск: поиск поисках 
качество: качеству качества качество 
неокортикальный: неокортикальной 
дорогой: дорогое 
лишь: лишь 
отбор: отбор отбора отбору 
оставлять: оставляя 
кирпичик: кирпичиком 
свежий: свежий 
карма: карма 
закон: законов закон закона 
хабра: хабре хабр 
ген: генов 
взгляд: взгляд 
мейоз: мейоз 
миллион: миллионы 
неладный: неладную 
управление: управления 
имя: имени 
принцип: принцип 
орган: органов 
продолжаться: продолжающейся 
умение: умением 
несколько: несколько 
проголосовать: проголосовали 
патология: патологии 
некачественный: некачественных 
микрополип: микрополипы 
кривая: кривая 
отключить: отключить 
проанализировать: проанализировав 
неограниченный: неограниченное 
специфический: специфического 
настройка: настройка 
сожаление: сожалению 
возможный: возможна возможные возможны возможным 
вероятность: вероятности 
стать: статей станет стать 
биология: биология биологии 
вполне: вполне 
перечислять: перечислять 
профиль: профиль 
программа: программу программы 
деградация: деградация деградации 
человек: людям людей человека люди человек 
акула: акулы 
вероятный: вероятны 
писать: пишите 
давление: давление 
брать: беру 
пассивно: пассивно 
электронный: электронную 
постепенно: постепенно 
биологический: биологическим биологическое биологического 
обрушить: обрушенное 
генетически: генетически 
роботизированный: роботизированный роботизированная 
уровень: уровне уровень 
бытие: бытием 
эволюция: эволюции 
согласно: согласно 
научный: научных 
фактор: факторам факторы 
яманака: яманаки 
сопротивление: сопротивления 
ссылка: ссылки ссылка 
отдалить: отдалённое отдалённая 
тело: тело тела 
старый: старую старых 
подобный: подобные подобного подобная 
осознать: осознал 
сеть: сети 
свой: своему своей своим своими 
детально: детально 
мир: мире мира 
природный: природной 
эволюционный: эволюционное 
организм: организмы организме организма организм 
сознание: сознания 
эйнштейн: эйнштейнов 
аи: аи 
радикальный: радикальное 
технология: технология технологии 
её: её 
репарация: репарация 
умирать: умирают умирать 
сторона: стороны 
утрачивать: утрачивать утрачивают 
подумать: подумать 
инженер: инженер 
препарат: препаратами 
обратиться: обратиться 
разбирать: разбирал 
давать: давал давайте дают 
инновационный: инновационное 
накапливаться: накапливаться 
соответствовать: соответствующий 
перспективный: перспективных перспективной перспективные перспективными 
это: это 
несправедливость: несправедливостью несправедливости 
установиться: установившимся 
написать: написали 
повышаться: повышающейся 
совершенствовать: совершенствовать 
иметь: имеет 
группа: группу 
замена: замены 
бегло: бегло 
задача: задачу 
конструкция: конструкцию 
опубликовать: опубликовав 
наш: нашу нашего наш наших 
существовать: существуют 
поддержка: поддержка 
возрастной: возрастной 
явление: явлением 
наращивать: наращивая 
долголетие: долголетие 
межклеточный: межклеточного 
ряд: ряд 
совершенство: совершенство 
особо: особо 
хороший: лучший лучшие лучшее 
почему: почему 
сыворотка: сыворотка 
весьма: весьма 
время: временем время 
скорее: скорее 
пригласить: пригласить 
кольцо: кольцо 
способ: способ 
проводить: проводить 
хаба: хабы 
задать: заданную 
окончание: окончания 
мудрость: мудрость 
барамия: барамии 
крионик: крионика крионики крионике 
гипотетический: гипотетическая 
погибать: погибают 
болезнь: болезни 
образ: образом 
вопрос: вопросов вопросы вопрос 
процент: процентов 
восстановление: восстановления 
хронический: хронического 
приглашать: приглашаем 
направить: направленная 
единственный: единственный 
слепой: слепых 
неудачник: неудачником 
неопределённый: неопределенного 
способствовать: способствует 
идея: идеями идей идеей 
ещё: ещё 
интересный: интереснейших интересные 
происходить: происходит 
плоский: плоской 
умереть: умереть 
любимый: любимую 
проект: проект 
дальнейший: дальнейшие 
больший: большая 
рецептор: рецептор 
текст: тексту 
фашистский: фашистских 
хотеть: хотим 
понятие: понятие 
сущий: сущего 
течение: течение 
небольшой: небольшом 
важный: важное 
замедлять: замедляющих 
расщепление: расщепление 
обычно: обычно 
применить: применена 
понимать: понимаем понимать 
тег: теги 
пересадка: пересадка 
малышев: малышева 
выявить: выявлены 
выделить: выделить 
издревле: издревле 
теория: теории теория 
цинический: цинического 
рада: рады 
внутренний: внутренней 
кратко: кратко 
бессмертный: бессмертном бессмертных 
прочтение: прочтение 
первичный: первичный 
эксперимент: эксперименту 
новый: нового новые новых новое 
например: например 
информационный: информационная 
прежде: прежде 
поэтому: поэтому 
облегчение: облегчении 
изменение: изменений 
редактирование: редактирования 
представительство: представительства 
последствие: последствиями последствия 
максимально: максимально 
полова: половой 
делать: делать 
белок: белками 
голова: голову 
прийти: прийти 
направление: направлении направлению направления направлениям направление 
голый: голые 
непосредственно: непосредственно 
явный: явном 
главный: главной главные 
мнение: мнение 
евгений: евгения 
сосудистый: сосудистая сосудистой 
эффект: эффекты эффект 
ощущать: ощущал 
протяжение: протяжении 
рабочий: рабочую 
запрограммировать: запрограммировано 
один: одна 
поздно: поздно 
жертва: жертва 
поздний: позднем 
запуск: запуска 
контролировать: контролируемого контролировать 
отнюдь: отнюдь 
открытый: открытым 
каждый: каждого каждом 
удар: ударов 
сшивка: сшивок сшивки 
землекоп: землекопы 
позволить: позволил 
ибо: ибо 
знакомиться: знакомиться 
явно: явно 
особый: особой 
итак: итак 
получить: получить 
польза: пользу 
зарубежный: зарубежный 
приводить: приводит 
дегенерация: дегенерации 
рождение: рождения 
называть: называемые 
рф: рф 
день: день 
гарантировать: гарантированного 
печать: печать 
медицина: медицины медицина 
создать: создать 
негативный: негативные негативный 
зуб: зубов 
такой: такого таким такая 
трёхмерный: трёхмерная 
ставиться: ставилась 
титанический: титанических 
регенеративный: регенеративная 
днк: днк 
подход: подхода 
антивозрастной: антивозрастная 
инферно: инферно 
интеллект: интеллекта интеллект 
общедоступный: общедоступными 
важно: важно 
всё: всё 
вскоре: вскоре 
инициативный: инициативную 
поддержание: поддержания 
назад: назад 
сам: само 
оборвать: оборвёт 
корректировать: корректировать 
стенка: стенки 
криокомпания: криокомпаний 
иметься: имеется 
версия: версию 
хотя: хотя 
правило: правилам 
следующий: следующий 
зверский: зверских 
повторный: повторного 
ничто: ничто 
помочь: поможет помогут 
эластичность: эластичности 
микробиолог: микробиологов 
обкатывать: обкатывать 
указывать: указывает 
общий: общем 
постоянный: постоянного постоянная 
защита: защиты 
задействование: задействованием 
цель: цели цель 
также: также 
международный: международное 
черта: черты 
менее: менее 
рой: рой 
межгосударственный: межгосударственный 
зрелость: зрелости 
страдать: страдать 
мутация: мутации 
тварь: твари 
переходить: переходим 
работать: работают работать 
причина: причины причин 
генетика: генетика 
начало: начале 
уточнить: уточнить 
наиболее: наиболее 
плюс: плюс 
мы: нам нами 
общественный: общественным 
вмешательство: вмешательства 
история: истории 
первый: первой первым 
нестерпимый: нестерпимый 
большинство: большинство 
опираться: опираясь 
приговорить: приговорён 
надёжный: надёжных 
рассказать: расскажем 
секрет: секрет 
некоторый: некоторые 
редкий: редким 
игорь: игорь 
создатель: создатель 
достаточно: достаточно 
движущий: движущей 
практически: практически 
вариант: варианты 
антонович: антоновича 
сотрудничество: сотрудничество сотрудничеству 
бой: бой 
гидра: гидрами 
обеспечивать: обеспечивает 
пусть: пусть 
всеобщий: всеобщего 
рак: рака 
взрослый: взрослой 
ранее: ранее 
следовать: следует 
вечный: вечной 
отступление: отступление 
откат: откат 
передовой: передовых 
почта: почту 
изучать: изучать 
миллиард: миллиарды миллиардом 
внеклеточный: внеклеточном 
уклад: уклад 
квантовый: квантовая квантового 
потребовать: потребует 
борьба: борьба борьбы 
мина: мин 
говорить: говорит 
мечтать: мечтал 
воздержаться: воздержались 
призвать: призваны 
морщина: морщины 
взаимодействие: взаимодействия 
усилие: усилиях 
увеличение: увеличении 
жизнь: жизни 
обеспечить: обеспечит 
сутки: сутки 
крайне: крайне 
раковый: раковых 
геронтолог: геронтологов 
заразить: заразить 
мозг: мозга 
стихийный: стихийных 
п: п 
склонить: склонить 
самый: самое самые 
потерять: потерявшего 
выпасть: выпадет 
любой: любых любом 
нужный: нужен 
преимущество: преимуществ 
геронтология: геронтология 
грех: грех грехе 
чувство: чувствами 
согласие: согласию 
разработать: разработать 
состариться: состарился 
суперприложение: суперприложение суперприложения 
повышать: повышают 
сергей: сергей 
инсталляция: инсталляция 
выше: выше 
постоянно: постоянно 
аналитический: аналитического 
искусственный: искусственное искусственный 
межбелков: межбелковых 
геном: генома 
расчётный: расчетного 
начать: начнём 
слепнуть: слепнут 
благородный: благороднее 
последний: последний 
изучить: изучены 
рпж: рпж 
немного: немного 
приведение: приведение 
каменеть: каменев 
рейтинг: рейтинг 
мамука: мамуки 
щедрый: щедрой 
отметить: отметим 
другой: другие других 
убедительно: убедительно 
оставаться: остаётся 
однократно: однократно 
бессмертие: бессмертие 
перенести: перенесено 
естественный: естественного естественный 
весь: всей 
модуль: модуля 
эпигенетический: эпигенетический 
участь: участь 
разработка: разработка 
тень: тени 
предполагаться: предполагается 
видение: видением 
технический: техническая 
отсутствие: отсутствие 
отдельно: отдельно 
условие: условиях 
кожа: кожи 
количество: количество количестве 
пока: пока 
отпустить: отпущена 
момент: момента 
доля: долю 
беспощадный: беспощадного 
регенерация: регенерации регенерацию 
окружающий: окружающего 
стареть: стареет 
опрос: опросе 
либо: либо 
заведомо: заведомо 
репродуктивный: репродуктивного 
изначально: изначально 
найти: найдут 
закладка: закладки 
суровый: сурового 
открывать: открывать 
пора: пор 
небиологический: небиологическое 
нацелить: нацеленного 
слово: слово 
похожий: похожие 
вернуться: вернуться 
показывать: показывает 
безнадёжный: безнадежной 
предполагать: предполагает 
смысл: смысл 
счёт: счёт 
этап: этап 
внедрять: внедрять 
потеря: потеря 
сразу: сразу 
главное: главное 
клеточный: клеточной 
убедить: убеждены 
государственный: государственный 
жить: жить 
обновить: обновить 
вытащить: вытащить 
аутоиммунный: аутоиммунного 
утилизация: утилизация 
посредством: посредством 
сегодняшний: сегодняшний 
пойти: пойдёт 
включить: включить 
отнять: отняли 
дать: данные 
искать: искать 
принимать: принимать 
взаимосвязь: взаимосвязей 
основа: основе 
нисколько: нисколько 
идти: идти 
просмотр: просмотров 
ребёнок: детей 
навсегда: навсегда 
повторяться: повторяться 
публикация: публикации 
решение: решения 
соответствующий: соответствующих 
так: т 
человечество: человечеству 
иван: ивана 
набор: набор 
воспаление: воспаления 
трансплантация: трансплантация 
комплексный: комплексной 
иной: иных 
предначертать: предначертано 
разобрать: разобрал 
гибридный: гибридная 
появляться: появляются 
воплотить: воплощена 
память: памятью 
синклер: синклера 
композитный: композитных 
гигантский: гигантском 
технологический: технологический 
они: ними 
убийство: убийство 
заставить: заставить 
исторический: исторической 
поставить: поставить 
сложный: сложнейшей 
фактически: фактически 
писатель: писателя 
объединение: объединение 
порочный: порочен 
попутный: попутное 
смочь: сможет 
мыслящий: мыслящему 
исполнение: исполнения 
учёный: учёного 
образоваться: образующиеся 
перспектива: перспектива 
изменить: изменить 
криобиолог: криобиологов 
голограмма: голограмма 
рано: рано 
тысяча: тысячи 
случай: случае 
создание: создания 
параллельно: параллельно 
отодвигание: отодвигание 
тысячелетие: тысячелетиями 
соавтор: соавторов 
час: часов 
водный: водные 
тема: теме 
облако: облако 
стволовой: стволовых 
накопление: накопления 
шанс: шанс 
первородный: первородном 
вообще: вообще 
процесс: процесса 
скорость: скорости 
