следовать: следовать 
компетенция: компетенции 
задача: задачи задача задачам задач задачах задаче задачу 
концепт: концепта концептом концепт 
техника: технику 
день: дня день дней 
заказчик: заказчиком заказчику 
планировать: планирует 
спать: спать 
мит: мит мита 
подействовать: подействовал 
запыхаться: запыхавшись 
хм: хм 
вывод: выводу 
мировой: мировой 
агим: агимы агиме 
краткий: кратким 
наблюдать: наблюдать 
частность: частности 
шутейка: шутейку 
тратить: тратить трачу 
смочь: смог 
обсуждать: обсуждает обсуждаем 
давно: давно 
яндекс: яндекс 
заряжать: заряжать 
тимлид: тимлидов 
коллега: коллег коллеги коллегами 
дизайн: дизайн дизайном дизайна 
мой: моей моим мою 
дима: диме дима 
всякий: всяким всякое 
заниматься: занимаюсь занимается занимаются 
агентство: агентстве агентство 
срастись: срослось 
видимо: видимо 
соответственно: соответственно 
исследование: исследований 
главное: главного 
индустрия: индустрии 
входить: вхожу 
почта: почте почты почту 
наш: наше нашего наш нашему 
сам: самого самом сами 
искромётный: искрометную 
собираться: собираемся собирался 
проработать: проработан 
ключевой: ключевым 
знать: знаете знаю 
вводный: вводную 
один: одну одним одно 
комментарий: комментарии 
организовать: организовать 
гриша: гриши 
раз: разу 
разработчик: разработчики 
голос: голосов 
мобильный: мобильных 
молодец: молодцы 
удача: удачи 
суматоха: суматохе 
весёлый: веселый 
тема: темы 
меню: меню 
отрываться: отрываюсь 
посмотреть: посмотреть 
ехать: ехать 
текст: текстах текст 
котик: котики котиков 
лихо: лихо 
команда: командой команду команд команда 
привыкнуть: привыкли 
далее: д 
контроль: контроля 
задавать: задаю 
чай: чай 
тимлидский: тимлидские 
часть: часть 
злиться: злюсь 
ругаться: ругаются 
классный: классный классного классные классным 
представляться: представляемся 
мочь: мог можем могу 
приходить: приходили прихожу 
конец: конце конца 
календарь: календаря календаре календарь 
глаз: глаз 
риторический: риторический 
красивый: красивую красивые 
обдумать: обдумать 
агимовчанка: агимовчанка агимовчанку 
лидоконвертация: лидоконвертацией 
понедельник: понедельник 
созвон: созвон созвоне 
понимать: понимаете понимают понимаю понимаем понимать 
автоматический: автоматическими 
дело: деле дела дело 
мысль: мысль 
выкидывать: выкидываю 
папочка: папочку папочкам 
понедельничный: понедельничный 
садик: садикам 
рассказывать: рассказывают рассказываю рассказывает 
свой: свой свои своей своим 
весточка: весточку 
офигенный: офигенный 
помогать: помогаю 
добавить: добавить 
уметь: умел умеем 
очередь: очереди 
шикарный: шикарные 
лерин: лерины 
типичный: типичный 
клиент: клиентом клиент клиента клиенту 
неистовый: неистово 
формально: формально 
требовать: требующего требует требующие 
такой: такие такое такого 
кто: кого кому 
пожелание: пожелания 
нужно: нужно 
интересно: интересно 
арт: арт 
клуб: клуб 
международный: международного 
интегратор: интегратор 
что: чему 
периодически: периодически 
равно: равно 
погнать: погнали 
конверсия: конверсий конверсии 
никто: никто 
новый: новую новые новых новой 
сделать: сделать 
безжалостно: безжалостно 
другой: другими другое 
язык: языка язык 
который: которые который котором которого 
отложить: отложенные 
мобилка: мобилку 
бывший: бывших бывшим 
рабочий: рабочего рабочий рабочие рабочих 
дзен: дзен 
возможность: возможность 
друг: другом 
опаздывать: опаздывает 
итог: итоге итогам 
недосягаемый: недосягаемую 
поздний: позже попозже 
брифинг: брифинг 
грядущий: грядущий 
трафик: трафика 
развитие: развития развитие 
тщательно: тщательно 
лень: лень 
образовательный: образовательная 
выяснять: выясняю 
административный: административные 
агимовчанин: агимовчанина агимовчанин 
курс: курс 
делать: делают делаем делаю делать 
разбор: разбором разбор 
физически: физически 
старый: старым старую 
бэклога: бэклог 
интересный: интересный интересное 
влезать: влезал 
рассказать: рассказала расскажу 
поиск: поиск поиску 
ладный: ладно 
желать: желаю 
давный: давным 
заодно: заодно 
заказ: заказы 
карма: карма 
соцсеть: соцсетей соцсетях соцсети 
бытовой: бытовые 
инбокс: инбокс инбоксе инбокса 
остроумный: остроумную 
попадаться: попадается 
нравиться: нравился нравится 
пройти: прошел 
событие: события 
работа: работы работу 
визуальный: визуальной визуального 
приложение: приложений 
внимательно: внимательно 
неделя: неделю неделе 
отдать: отдать 
весело: весело 
тимлида: тимлиду 
собес: собес 
наверное: наверное 
давать: даю 
ждать: ждать 
ответ: ответам ответа 
несколько: несколько 
хвалить: хвалю 
лера: лера лерой лере 
добавлять: добавляю 
доверять: доверяют 
развивать: развивают 
сегодня: сегодня 
решение: решений решение 
настройка: настройка 
привет: привет 
квартальный: квартальные 
сожаление: сожалению 
два: двумя 
уведомление: уведомлений уведомление уведомления 
профиль: профиль 
пол: пол 
неожиданный: неожиданное 
правильно: правильно 
далеко: далеко 
слушать: слушаю 
плохо: плохо 
неправильно: неправильно 
слайд: слайды слайдов 
смотреть: смотреть смотрю 
норма: норм 
мессенджер: мессенджер 
качество: качества 
накидать: накидал 
петровка: петровке 
чат: чате чаты 
захват: захват 
подглядывать: подглядывать 
успевать: успеваю 
около: ок 
подключаться: подключаюсь 
делегировать: делегировал 
желание: желание 
наметать: наметан 
серьёзный: серьезное 
биханс: биханса 
получать: получают 
логотип: логотипы логотипом 
просить: просит 
надеяться: надеяться 
азия: азии 
перебраться: перебралась 
презентовать: презентуем 
увидеть: увидеть 
объяснимый: объясним 
прогулка: прогулки 
дата: дату 
скучный: скучных скучные 
послезавтра: послезавтра 
появиться: появилось 
перестать: перестань 
еда: еду 
позаниматься: позаниматься 
прорвать: прорвало 
это: это 
поехать: поехать 
загадка: загадка 
первый: первого первая 
эмоджи: эмоджи 
вакансия: вакансию 
отвечать: отвечаю 
тг: тг 
сайт: сайты сайт 
особый: особых 
редактор: редактор 
поддержка: поддержка 
додумать: додумать 
отказывать: отказываю 
срез: срезы 
деталь: детали 
покончить: покончено 
уточнять: уточняю 
поток: потока 
попасть: попал 
видеть: видел видит 
костя: костя 
какой: какое какие каком 
телеграм: телеграм 
партнёр: партнеров 
почему: почему 
человек: людей люди человек 
защита: защиту 
закрывать: закрываю 
скорее: скорее 
картинка: картинками картинки картинку 
стул: стуле 
сидеть: сидела 
косяк: косяк 
изредка: изредка 
голова: головы головой 
должный: должен 
хаба: хабы 
происходить: происходящее происходит 
разобрать: разобрать 
невероятный: невероятную 
справиться: справились справился 
неудачник: неудачник 
шкурка: шкурку 
тим: тим 
туман: тумане 
минута: минут 
проконтролировать: проконтролировать 
прорыв: прорывов 
получиться: получилось 
выйти: выйдет вышло 
думать: думать 
звать: зовут 
туториал: туториал 
вне: вне 
затягиваться: затягивается 
идея: идее 
время: времени время 
год: года 
посетить: посетить 
пользователь: пользователь 
основной: основной 
хороший: хороший лучшие 
состояние: состояние 
грустить: грущу 
участвовать: участвует 
закинуть: закинуть 
собирать: собирать 
незаметно: незаметно 
пустой: пустого 
обсудить: обсудили обсудить 
проект: проект проекта проекте 
компания: компанию компании компаний 
проектировщик: проектировщик 
остальной: остальное 
заглядывать: заглядывал 
изучить: изучить 
постить: постить 
слишком: слишком 
письмо: письма писем 
важный: важное важная 
гордый: гордый 
преза: презу презой 
снова: снова 
течение: течение 
аутстафа: аутстаф 
обычно: обычно 
тег: теги 
обнуляться: обнуляюсь 
открывать: открываю 
начаться: начался 
забить: забить 
проснуться: проснулся 
митапа: митап 
девушка: девушка 
офис: офис 
внутренний: внутренней внутренних 
кратко: кратко 
прочтение: прочтение 
интересант: интересантам 
заново: заново 
просматривать: просматриваю 
эйчар: эйчары эйчаров эйчар 
предварительный: предварительная 
куча: кучу 
формальный: формального формальная 
поэтому: поэтому 
замьючен: замьючены 
высота: высоту 
скажем: скажем 
причёсывать: причесываю 
коммуникация: коммуникации 
обиженный: обиженный 
отрепетировать: отрепетировать 
подготовить: подготовил 
идти: идут идти иду 
неповторимый: неповторимой 
опоздание: опозданием 
вопрос: вопросы вопроса вопрос 
слово: словами 
лента: ленту 
вперёд: вперед 
вовсю: вовсю 
копать: копать 
серьёзно: серьезно 
тянуть: тянет 
статья: статья 
договариваться: договариваемся 
самоорганизоваться: самоорганизовались 
стажёр: стажеров стажерами стажерам стажера 
дизайнер: дизайнеров дизайнеры дизайнера 
очень: очень 
восхищаться: восхищаться 
ухо: уха 
досидеть: досидев 
кстати: кстати 
встреча: встречи встречах 
двигать: двигать 
процесс: процессу процессов 
десятка: десяток 
чисто: чисто 
внимание: внимания 
кроме: кроме 
помочь: помочь 
младший: младший 
садиться: сажусь 
профукать: профукал 
манера: манере 
онлайн: онлайн 
отправлять: отправляю 
условие: условиям 
обкатывать: обкатывал 
разведка: разведки 
архив: архив 
оценивать: оценивать оцениваю 
мидлый: мидлы 
рассылка: рассылок 
среагировать: среагировать 
просто: просто 
портфолио: портфолио 
прототип: прототип прототипа 
обратный: обратную 
статус: статус 
проходить: проходят 
канал: канал 
пост: постами пост 
захлопывать: захлопываю 
нормально: нормально 
байка: байка 
чашка: чашку чашкой 
эффективный: эффективнее 
всё: всё 
объяснение: объяснениями 
придумывать: придумываю 
ставить: ставлю 
полезный: полезные 
назад: назад 
правка: правки 
окно: окно 
минорный: минорные 
успеть: успев 
прочитать: прочитанным 
версия: версию 
хотя: хотя 
вместо: вместо 
познакомиться: познакомиться 
удивление: удивление 
месяц: месяцев 
понять: понять понял 
партнёрский: партнерских 
дорога: дорогу 
пародия: пародию 
отмечать: отмечаю 
общий: общем общий 
решать: решали решаем решать решаю 
исключение: исключение 
потрясать: потрясающих 
менее: менее 
кандидат: кандидат 
переходить: переходим 
директорский: директорские 
воспринимать: воспринимайте 
ребёнок: ребенок детей 
утренний: утренней 
реакция: реакцию 
мозг: мозг 
мы: нам 
директор: директору директора директор 
дослушать: дослушать 
секунда: секунд 
донести: донесем 
заходить: захожу 
программа: программе 
пообедать: пообедать 
школа: школам 
референс: референс 
комментировать: комментировать комментирую 
напихать: напихал 
обработка: обработке 
переместиться: переместилась 
ответить: ответить 
верховный: верховный 
похожий: похожему похожие 
вариант: варианты вариантов 
отшучиваться: отшучиваюсь 
фигня: фигней 
креативный: креативного 
штурм: штурм 
важность: важность 
пусть: пусть 
стараться: стараясь стараюсь 
вчера: вчера 
натянуть: натянул 
разгрести: разгрести 
крепенький: крепенькие 
аня: аня 
полчаса: полчаса 
разогнать: разогнав 
довольный: доволен 
мотать: мотаю 
митинг: митинга 
заметить: замечу 
целое: целом 
отметить: отметить 
извиняться: извиняюсь 
раскидываться: раскидываются 
оставлять: оставляю 
мина: мин 
индивидуально: индивидуально 
центр: центре 
отправить: отправьте 
неплохой: неплохое 
твиттер: твиттере 
холодное: холодные 
вина: вины 
работать: работает работаю 
сутки: сутки 
стол: стол 
отдел: отделом отдел 
тяжело: тяжело 
офлайн: офлайн 
карьера: карьера 
заметка: заметки 
обед: обеда 
вряд: вряд 
остров: остров 
тренироваться: тренируются 
изменение: изменения 
нужный: нужен 
болтать: болтаем 
священный: священного 
этот: этих 
сергей: сергей 
групповой: групповые 
презентация: презентация 
залипнуть: залипнуть 
входящий: входящих 
говорить: говорят 
быть: будем 
сохранять: сохраняю 
выходной: выходных 
заобсуждаться: заобсуждался 
потерять: потеряли 
вспоминать: вспоминаю 
опоздать: опоздал 
немного: немного 
профессиональный: профессиональное 
хотеть: хотите хочу 
вроде: вроде 
рейтинг: рейтинг 
любить: любят 
час: час 
радовать: радовать 
выбрать: выбрать 
собеседование: собеседование 
каждый: каждый 
пробежать: пробежать 
далёкий: дальше 
улучшать: улучшал 
пробегаться: пробегаюсь 
запрос: запросы 
подхватить: подхватить 
последний: последних 
весь: всей 
технический: техническая 
зелёный: зеленой 
количество: количество 
пока: пока 
составить: составить 
называться: называется 
обсуждение: обсуждения 
ребята: ребятами 
прощаться: прощаемся 
итерационный: итерационного 
закладка: закладки 
устроенный: устроен 
услышать: услышанное 
большой: большому 
ошибка: ошибок 
пропустить: пропустить 
вернуться: вернуться 
корпоративный: корпоративному 
многие: многие 
сказать: сказанное 
пометка: пометку 
подсунуть: подсунуть 
себя: собой 
обеденный: обеденного 
завтра: завтра 
хабра: хабр 
знакомство: знакомство 
влетать: влетает 
выполнить: выполнить 
дом: дома 
сразу: сразу 
долго: долго 
хватать: хватает 
удаваться: удается 
уходить: ухожу 
обновить: обновить 
гореть: горит 
возвращаться: возвращается 
крупный: крупнейший 
дорогой: дорогие 
снимать: снимают 
добить: добью 
уууъъ: уууъъ 
упоминать: упоминали 
сконцентрироваться: сконцентрироваться 
написать: напишите 
поддержать: поддержать 
пить: пью пить 
складывать: складываю 
значит: значит 
стажерство: стажерства 
переслать: переслать 
провести: провести 
просмотр: просмотров 
публикация: публикации 
отпускать: отпускаю 
контекстный: контекстные 
справляться: справляюсь 
ноутбук: ноутбук 
так: т 
веселиться: веселился 
вечером: вечером 
парковый: парков 
тендер: тендера тендер 
появляться: появляюсь 
план: план 
прогресс: прогресс 
мало: мало 
фильтр: фильтрами 
дёшево: дешево 
начинать: начинаем 
драгоценный: драгоценное 
связь: связь 
трепаться: треплемся 
подобрать: подобрать 
митя: мите 
восхищение: восхищения 
радость: радость 
фактически: фактически 
расписание: расписанию 
квартал: квартал 
ух: ух 
мир: мира 
ретро: ретро 
вывести: выведут 
достигать: достигать 
проверить: проверит 
основное: основном 
неправильный: неправильный 
следующий: следующего 
море: моря 
вариация: вариаций 
личный: личное 
сантиметр: сантиметров 
налить: налит 
отвлечься: отвлекся 
случай: случае 
блог: блог 
лопатка: лопаткой 
быстро: быстро 
пересматривать: пересматриваю 
параллельно: параллельно 
кофе: кофе 
ежедневный: ежедневные 
сытый: сытый 
решить: решил 
вообще: вообще 
сначала: сначала 
портал: портала 
огий: огого 
мозговой: мозговой 
любой: любом 
к: ко 
