связывать: связывающего связывают 
весь: весь всему всем 
лицо: лицо лиц 
бесплатно: бесплатно 
перспективный: перспективный 
вывод: вывод 
подписка: подписках подписки подписок 
блокчейн: блокчейн 
считаться: считается считаются 
реферальна: реферальной 
являться: является являются 
зачастую: зачастую 
экосистема: экосистемах 
рискнуть: рискнуть 
сервис: сервиса сервисов сервис 
друг: друга 
поле: поле 
тратить: тратить 
баблосбор: баблосбор 
совмещать: совмещать 
выстрелить: выстрелит 
стартап: стартап стартапы стартапа 
внимание: внимание внимания 
вакансия: вакансий вакансии 
пользователь: пользователи пользователей 
яндекс: яндекс 
поскольку: поскольку 
неполный: неполным 
ярлык: ярлык 
возможно: возможно 
создатель: создателям 
некоторый: некоторое 
смотреть: смотрим 
содержание: содержание 
биржа: биржах 
сам: самого 
шаг: шагом 
углубление: углубление 
ключевой: ключевым 
упасть: упасть 
запуск: запуском 
представлять: представляет представляющего 
комментарий: комментарии комментариях 
голос: голосов 
инвестор: инвесторов инвестора инвесторами инвесторы инвесторах 
какой: какого какую какое каких какие 
случай: случаи случае 
сторона: стороной стороны 
инвестиция: инвестиций 
реальный: реальные 
страница: страницу страницах 
меню: меню 
должный: должны 
посмотреть: посмотреть 
изучить: изучив 
клон: клонов 
судить: судя 
программист: программист 
сомнительный: сомнительного сомнительных сомнительным сомнительные 
отдельный: отдельное 
домен: домен 
поиск: поиске поиск поиском 
инвестировать: инвестировали 
именно: именно 
заявить: заявить 
часто: часто 
исключение: исключений 
свой: свой свои своем свое 
полный: полную 
добавить: добавить 
год: лет году года 
однако: однако 
появиться: появился появилось 
формально: формально 
подписчик: подписчиков 
сто: сто 
такой: такие такая таких 
нужно: нужно 
продвижение: продвижением 
имя: имена 
модератор: модератором 
ответственный: ответственных 
ранний: раньше ранних 
инфлюенсер: инфлюенсеры инфлюенсеров 
выполнить: выполнив 
уверенный: уверенным 
сделать: сделать 
мера: мера 
никто: никто 
набрать: набрать набрал набравшую 
официальный: официальном официальной 
который: которые которая который 
получаться: получается 
криптовалютный: криптовалютная 
язык: языка язык 
идея: идея идею 
вложить: вложенные 
дзен: дзен 
волна: волне 
вкладка: вкладке 
противоправный: противоправных 
остановиться: остановиться 
произойти: произошел 
комнд: комнды 
преследовать: преследующих 
скама: скама 
подозрение: подозрение 
зрение: зрения 
тот: те 
криптопроект: криптопроект криптопроектах 
поддержка: поддержке поддержка поддержки 
аудит: аудит 
лишь: лишь 
сайт: сайте сайт 
опция: опции 
карма: карма 
серьёзный: серьезная серьезных 
последующий: последующего 
пройти: прошел 
работа: работы работа 
уделять: уделять 
соцсеть: соцсетях 
интеллект: интеллектом 
ждать: ждать 
начинаться: начинаются 
несколько: несколько 
далее: далее 
большой: большого 
аккаунт: аккаунта аккаунт аккаунты аккаунту аккаунтов 
недавно: недавно 
профиль: профиля профиль профили 
поисковый: поисковую 
некачественный: некачественных некачественный 
настройка: настройка 
быть: суть будем будут 
фонд: фондов фондам фондами фонд фонды 
распределение: распределении 
связь: связи связей связь 
обращать: обращать обращайте 
маленький: меньше маленьких 
далеко: далеко 
трудоустроить: трудоустроены 
детальный: детальную 
показаться: показаться 
мочь: можем можете 
развитие: развитием 
начало: начала 
оставить: оставили 
согласно: согласно 
самый: самый 
капитал: капиталом капитала капиталов капиталах 
венчурный: венчурного венчурных венчурным 
социальный: социальные социальных 
видимость: видимость 
ссылка: ссылки ссылке ссылка 
выделить: выделим выделены 
старый: старую 
дать: даст данные 
крайний: крайняя 
сеть: сети сетей 
решить: решила 
мир: мире 
невозможно: невозможно 
ключ: ключ 
получать: получают 
икс: иксы 
рекламировать: рекламируют 
увидеть: увидеть 
наличие: наличие наличии наличия 
дата: дату 
необходимый: необходимым 
токен: токены токенов токен 
руководитель: руководителей 
перейти: перейдя 
указать: указали указал указать 
заполнить: заполнены 
это: это 
ознакомиться: ознакомиться 
заметить: заметить заметили 
группа: группу 
понятно: понятно 
команда: команды команда 
обещать: обещает 
выпустить: выпустить 
этап: этапе этап этапах 
наш: нашу 
аудитория: аудиторию 
деталь: детали деталь 
единственный: единственная 
делать: делаем 
нередкий: нередки 
опыт: опыт 
показать: показать покажет 
предоставить: предоставленные 
февраль: феврале февраля 
заходить: заходим 
скорее: скорее 
крупный: крупных 
хаба: хабы 
финансовый: финансовыми 
представить: представленных 
подряд: подряд 
талант: талантов 
крипта: крипты 
месяц: месяц месяцев 
заработать: заработать 
думать: думать 
подписываться: подписывается 
усилие: усилий 
время: времени время 
основной: основной 
разбор: разбор разборе 
практика: практике 
неразобраться: неразобравшегося 
происходить: происходит 
пролистывать: пролистываем 
взлететь: взлететь 
первый: первое первых первым 
проект: проект проекта проектом проектов проекте проекты 
отсутвовать: отсутвует 
качество: качестве 
очки: очки 
последний: последнего 
выбрать: выберем 
сформировать: сформировать 
неплохой: неплохого неплохие неплохой 
обычно: обычно 
ненадёжный: ненадежные 
понимать: понимаем 
тег: теги 
указывать: указывают указывает 
средство: средства 
продукт: продукт 
вниз: вниз 
ценность: ценности 
шапка: шапке 
раздел: раздел разделы 
исчезнуть: исчезнуть 
млн: млн 
рада: рады 
прочтение: прочтение 
добавлять: добавляя 
сотрудник: сотрудниками сотрудников 
например: например 
партнёр: партнеры 
поэтому: поэтому 
искать: ищем 
интернет: интернет интернете 
глубокий: глубже 
успех: успеха 
биткоина: биткоин 
вопрос: вопросы 
обходить: обходить 
минь: мини 
очень: очень 
каждый: каждого каждый 
хороший: хорошие лучшие 
человек: люди 
топ: топ 
вызывать: вызывают 
источник: источника 
сортировать: сортирует 
действительно: действительно 
основатель: основателей 
блогер: блогера 
сколько: сколько 
отсутствие: отсутствии 
деньга: деньги денег 
дорожный: дорожной 
найти: найден найти 
появляться: появляется появляются 
создать: создать создан 
просто: просто 
место: место 
проходить: проходят проходит 
назад: назад 
подробный: подробнее 
иметься: имеется 
затем: затем 
использование: использовании 
версия: версию версии 
хотя: хотя 
пробить: пробить 
ваш: ваши 
соотнести: соотнести 
проверить: проверим проверить 
прожить: проживут 
инвестирование: инвестирования 
известный: известных известен 
неанонимный: неанонимной 
также: также 
элемент: элементы 
приложить: приложив 
переходить: переходим 
работать: работают работал работать 
краткий: краткое 
мы: нам 
популярность: популярность 
ск: скам 
история: истории 
большинство: большинство 
бизнес: бизнес 
уровень: уровней 
влиятельный: влиятельные 
очко: очков 
распознать: распознать 
зарегистрировать: зарегистрирован 
попадать: попадают 
разглядеть: разглядеть 
важный: важная 
листинг: листинга листинг 
достаточно: достаточно 
практически: практически 
анализ: анализ 
привлечение: привлечение 
ответить: ответить 
правдивость: правдивость 
публичный: публичным публичная 
мошенник: мошенник 
норма: нормой 
вчера: вчера 
интересный: интересные интересны 
нарушение: нарушение 
информация: информацию информации 
начислять: начисляет 
потенциальный: потенциальный 
один: одно 
вставлять: вставляем 
документация: документации 
продать: продать 
рухнуть: рухнут 
подписать: подписаны подписана подписан 
хайп: хайпом хайпа хайп 
мина: мин 
личность: личности 
потерять: потерять 
твиттер: твиттере твиттеру твиттер 
давать: давайте дает 
сутки: сутки 
листать: листаем 
июнь: июня 
компания: компания компаний 
продажа: продажа 
вышеперечисленный: вышеперечисленного 
раунд: раундах 
крутой: крутой 
разработчик: разработчик разработчиков 
вряд: вряд 
реклама: рекламы рекламой 
правило: правил 
восемь: восьми 
технология: технологии 
простой: проста 
канал: канале 
сео: сео 
проанализировать: проанализировать 
январь: январе января 
результат: результаты 
удалить: удалены 
метавселенная: метавселенными 
заявлять: заявляет заявляющих 
убеждаться: убеждаемся 
данные: данных 
пример: примере пример 
рассматривать: рассматривать 
несчастие: несчастью 
материал: материалы 
установить: установить 
рейтинг: рейтинг 
бесплатный: бесплатной 
проверка: проверку проверка 
сомнение: сомнения 
другой: другие 
обойти: обойти 
спустя: спустя 
далёкий: дальше 
платформа: платформа 
строка: строку 
технический: техническая технической 
криптовалюта: криптовалюта криптовалюты 
полностью: полностью 
трудоустройство: трудоустройства 
новичок: новичка 
количество: количество 
главный: главные 
пока: пока 
заниматься: занимаются 
либо: либо 
дополнительный: дополнительную 
отчасти: отчасти 
скам: скамом 
закладка: закладки 
разбирать: разбираем 
действие: действий 
недавний: недавнему 
впечатление: впечатление 
площадка: площадке 
похожий: похожие 
вернуться: вернуться 
поисковик: поисковика 
сфера: сферу 
следующий: следующее 
представитель: представители 
хабра: хабр 
распродажа: распродажи 
низ: низ 
любой: любой 
датут: датут 
пустышка: пустышки 
таблица: таблицей таблице 
март: марта 
обман: обманом 
обновить: обновить 
посредством: посредством 
затрагивать: затрагивающие 
смочь: сможем 
карта: карте 
два: две 
запуститься: запустился 
закрытый: закрытых 
надёжность: надежности 
основа: основе 
цель: цель 
двое: двое 
стоить: стоит 
просмотр: просмотров 
провести: провести 
публикация: публикации 
никакой: никаких 
соответствующий: соответствующих 
выступать: выступает 
скамовыя: скамовый 
узнать: узнать 
копнуть: копнуть 
показатель: показатель 
вестись: ведется 
обещание: обещания 
фактор: фактором 
обязательно: обязательно 
гарантировать: гарантировать 
оба: обоих 
искусственный: искусственным 
находить: находим 
рост: роста 
советник: советниками 
разбираться: разбираетесь 
участник: участников 
готовый: готовы 
попробовать: попробуем 
слабый: слабый 
запускаться: запускается 
разобрать: разберем 
вообще: вообще 
видеть: видим 
отмечать: отмечают 
сначала: сначала 
длительный: длительный 
помогать: помогают 
убедиться: убедитесь 
числиться: числится 
