процесс: процессы процесс процессов процесса 
мочь: могут 
управление: управление 
ваш: ваш 
задача: задачи задач задаче задачу задачами 
структура: структура структуры 
принимать: принимают 
покидать: покидает 
непрозрачный: непрозрачное 
свой: своего свое 
большой: большой 
научиться: научиться 
контроль: контроль контроля контроле 
выйти: выйти 
предупредить: предупредил 
разработка: разработки разработке 
яндекс: яндекс 
предоставление: предоставление 
сложный: сложны сложнее 
консультирование: консультирование 
медленно: медленно 
сила: сил 
участвовать: участвовать 
система: система системы 
комментарий: комментарии 
год: год 
голос: голосов 
первостепенный: первостепенно 
позитивный: позитивная 
прибыль: прибыли 
меню: меню 
загруженность: загруженности 
который: которыми которой которая который 
апрува: апрува 
далее: д 
срок: сроки 
снижение: снижение снижения 
часть: часть 
зона: зон зоны 
руководитель: руководители руководителю руководителей руководителя руководитель 
коллега: коллеги 
помогать: помогать 
голова: голове 
часто: часто 
переходить: переходит переходят 
неоптимальный: неоптимально 
добавить: добавить 
хвататься: хватается 
однако: однако 
помощь: помощью помощь 
развитие: развитии развития развитие 
случай: случаях 
ответственный: ответственных 
информирование: информирование 
равно: равно 
важный: важную важная 
никто: никто 
сделать: сделать 
юнит: юнитом 
отсутствовать: отсутствует 
язык: языка язык 
получаться: получается 
выстроить: выстроенные выстроенный выстроить 
находиться: находится 
принятие: принятия принятие принятии 
дзен: дзен 
возвращаться: возвращаться 
вопрос: вопросам вопросами вопросы вопрос 
интерпретироваться: интерпретируется 
горлышко: горлышком 
операционка: операционки операционка операционке 
поиск: поиск 
приоритет: приоритетов приоритеты 
отпускать: отпускать 
карма: карма 
клиент: клиент 
работа: работы работа 
орг: орг 
простой: простыми 
расти: растут расти растет 
выполнять: выполняет 
построить: построить 
фаундрать: фаундеру 
недавно: недавно 
поменять: поменять 
настройка: настройка 
решение: решений решению решение 
довольный: довольны 
ответственность: ответственности ответственность 
необходимо: необходимо 
ключевой: ключевые ключевых 
навык: навыки навыков 
договорённость: договоренности 
профиль: профиль 
человек: людям людей человека люди 
исполнитель: исполнителя 
ситуация: ситуация 
теряться: теряются 
оценка: оценку оценки 
тратить: тратят 
плохо: плохо 
постепенно: постепенно 
допустить: допущена 
снижаться: снижается 
повышаться: повышается 
внутренний: внутренний 
уровень: уровне уровень 
сжатый: сжатые 
фаундёр: фаундерам фаундера фаундер 
такой: такую такого 
желание: желание 
терять: терять 
старый: старую 
раз: раза 
просить: просит 
стратегический: стратегические 
сторона: сторона стороны 
разделение: разделение 
привычный: привычные 
наличие: наличие 
проект: проектами проектов проекты 
звучать: звучало 
мониторинг: мониторинг 
миша: миша 
неуверенность: неуверенность 
это: это 
фреймворк: фреймворк 
неправильный: неправильных неправильным 
член: члена 
требовать: требуют 
запрос: запрос запросом запроса 
команда: команды команду команде команд команда командами 
этап: этапе 
поддержка: поддержка 
единственный: единственная 
делать: делаем делать 
нехватка: нехватку нехватка 
функционал: функционал 
результативность: результативности 
рост: рост росте 
почему: почему 
критичный: критичная 
непонимание: непонимание 
финальный: финальных финальные 
результат: результат результатов результата результаты 
текущий: текущий текущим 
хаба: хабы 
узкий: узким 
делегировать: делегировать делегирует 
образ: образом 
внутри: внутри 
туториал: туториал 
определить: определить 
поведение: поведения 
время: времени время 
понимание: понимание 
сотрудник: сотрудники сотрудников сотрудник сотрудникам 
интерпретация: интерпретация 
бизнес: бизнеса бизнес 
уход: уходе 
приходиться: приходится 
обсудить: обсудили 
увеличиваться: увеличиваются 
прогресс: прогресса 
сам: самому 
обязанность: обязанностей обязанности 
промежуточный: промежуточные 
следующий: следующим следующего 
тег: теги 
стык: стыке 
какой: каких 
катастрофически: катастрофически 
прочтение: прочтение 
огромный: огромное 
вставать: встает 
поэтому: поэтому 
дальнейший: дальнейшем дальнейших 
особенно: особенно 
компания: компании 
вовсе: вовсе 
наблюдаться: наблюдается 
ошибка: ошибка 
качественно: качественно 
наём: найме найма 
возникнуть: возникнуть 
снятие: снятие 
отпустить: отпустить 
один: одна 
каждый: каждого каждом 
встреча: встречи встрече 
отчётность: отчетности 
способный: способен 
перестроить: перестроить 
итак: итак 
обращаться: обращается обращаются 
фоллоуап: фоллоуапы 
неподходящий: неподходящая 
успевать: успеваете 
операционный: операционная 
казаться: кажется 
контролировать: контролируем контролировать 
версия: версию 
кто: кому 
хотя: хотя 
странно: странно 
вырасти: выросла 
быстрый: быстрее быстрый быстром 
хаос: хаоса хаос 
также: также 
писать: пишет 
менеджер: менеджер менеджера 
постепенный: постепенном 
проблема: проблемы 
ревить: ревью 
мы: нам 
история: истории 
чувство: чувство 
прийтись: придется 
распределять: распределяют распределяем 
комментировать: комментировать 
ожидать: ожидаемого 
управленческий: управленческие 
инструмент: инструменты 
управлять: управлять 
отказ: отказ 
хороший: лучшие 
должный: должным 
вчера: вчера 
управленец: управленцев 
выстраивание: выстраивания 
погрязнуть: погряз 
одновременно: одновременно 
доверить: доверить 
паттерн: паттерны 
мина: мин 
продолжать: продолжала 
фидбек: фидбека 
риск: риск 
формат: формата 
работать: работает работаю 
сутки: сутки 
наш: наша 
связующий: связующих 
п: п 
другой: другая 
приходить: приходит 
решать: решаем решать решаю 
договариваться: договариваются 
кейс: кейс 
интервью: интервью 
входить: входит 
нанять: нанять 
разработать: разработать 
вакансия: вакансии вакансий 
проанализировать: проанализировать 
личностный: личностная 
выше: выше 
демотивация: демотивации 
постоянно: постоянно 
правило: правило 
выход: выходе 
непонятный: непонятного 
рейтинг: рейтинг 
больший: большую 
технический: техническая 
сложно: сложно 
главный: главная 
подтверждение: подтверждением 
отсутствие: отсутствие 
иной: иной 
самостоятельно: самостоятельно 
количество: количество 
подниматься: поднимаемся 
роль: роли ролей 
найти: найти 
прийти: пришел 
составлять: составляющих 
недоверие: недоверие 
заниматься: занимаются 
либо: либо 
компетентный: компетентного 
гораздо: гораздо 
чёткий: четкий 
нормальный: нормальным 
неплохо: неплохо 
закладка: закладки 
тонуть: тонут 
последний: последнее 
действие: действий 
выделение: выделение 
похожий: похожие 
вернуться: вернуться 
остановить: остановил 
фокус: фокус 
ощущение: ощущение 
себя: собой 
причина: причина 
хабра: хабр 
любой: любой 
сложность: сложности 
хватать: хватает 
продукт: продукта 
выступать: выступать 
обновить: обновить 
разобраться: разобраться 
деятельность: деятельность 
невозможность: невозможности 
принять: принять 
стартап: стартапа 
персонал: персоналом 
участие: участие 
значит: значит 
фиксировать: фиксируем 
последующий: последующий 
считать: считает 
провести: провести 
просмотр: просмотров 
публикация: публикации 
так: т 
план: план 
модерировать: модерирую 
синхронизация: синхронизации 
масштабирование: масштабировании 
потеря: потери 
слово: слова 
скорость: скорость скорости 
решаться: решаются 
число: число 
делегирование: делегирование 
передача: передаче 
быстро: быстро 
слабый: слабые 
сильный: сильного 
час: часов 
неэффективно: неэффективно 
ментор: менторов 
