весь: весь всем всей всеми 
мочь: могут могу можете 
система: системе система системы систему 
вероятность: вероятностью 
управление: управление управления 
ваш: ваш вашем вашу вашему ваших 
задача: задачи задач задачу 
проводить: проводите 
удивительно: удивительно 
приложение: приложения приложении 
различный: различных 
свой: своего свой свои своем своим 
реальный: реальных 
внедрить: внедрить внедрите 
ответ: ответ ответы 
большой: большой большого 
спасибо: спасибо 
проделать: проделанной 
второй: вторым 
стейкхолдер: стейкхолдеров стейкхолдера стейкхолдерам 
продукт: продуктах продуктом продуктов продукты продукту продукт продукте продуктами продукта 
зачастую: зачастую 
являться: является являются 
платформа: платформы платформа платформу 
частность: частности 
мысль: мыслями 
переиспользовать: переиспользовать 
действие: действия действий 
конечный: конечных конечного 
работать: работали работающие работают работает работал работать работаю 
один: одного одну одном одна одной 
разработка: разработки разработке разработку 
пользователь: пользователи пользователям пользователя пользователь пользователей пользователями 
яндекс: яндекс 
обработка: обработки 
отличаться: отличаются 
принести: принести 
сходиться: сходится 
метод: методы 
рекламный: рекламные рекламную рекламных 
возможно: возможно 
ожидание: ожиданий ожидания 
простой: простое простому простой 
финансовый: финансовые 
исследование: исследований 
погружение: погружения 
сам: самого сами сама 
обнаружить: обнаружите 
разобраться: разберемся разобрались разобраться 
иной: иными 
работодатель: работодателей 
получать: получать 
служить: служить 
сказать: скажет сказать 
выделить: выделил выделить 
существующий: существующий 
комментарий: комментарии 
спринт: спринта 
полезный: полезен 
поинта: поинта 
риск: риски риск 
голос: голосов голос 
связаться: связаться 
регулярный: регулярные 
случай: случай случаях случае 
крайность: крайность 
актив: активу активом активов актива 
навык: навык навыки 
приближение: приближении 
количество: количества количество 
наказание: наказание 
тезис: тезисами 
меню: меню 
насмотренность: насмотренность 
посмотреть: посмотреть 
твой: твой твоего 
гипотеза: гипотезы гипотез 
удобный: удобнее 
сохранение: сохранением сохранения сохранении 
предусматривать: предусматривают 
команда: командой команды команду команде команд команда 
привыкнуть: привыкли 
далее: д далее 
банк: банку банк банка банков 
иметь: имел 
цениться: ценятся 
собирать: собирали 
срок: сроки 
улучшение: улучшения улучшение 
визионерский: визионерская 
потратить: потратить 
рядом: рядом 
удивление: удивлением 
должный: должна должно 
именно: именно 
голова: голове 
важный: важных важна важным 
понимать: понимаете 
взаимодействие: взаимодействие взаимодействия 
часто: часто 
заполнение: заполнение заполнения 
классический: классических 
решение: решением решению решение решения 
тернистый: тернистом 
первухин: первухин 
добавить: добавить 
найти: найдите найти 
естественно: естественно 
серьёзный: серьезным 
офис: офисе 
помощь: помощью 
похожий: похожих похожие 
такой: такие такое таких 
основываться: основывался 
нужно: нужно 
кто: кого кому 
развитие: развитии развитие 
превращаться: превращается превращайтесь 
внедрение: внедрением 
минорный: минорными 
сделать: сделать сделаете 
подход: подход подходов подходом 
цифровой: цифровых 
усилие: усилия 
язык: языка язык 
хранение: хранения 
этот: этими этому этих 
который: которые которым которой которая который которую которого 
пользовательский: пользовательского пользовательскими 
показаться: показалось 
отчитываться: отчитываясь 
личный: личным личный личные 
внутренний: внутренние внутренний внутреннем внутренними внутреннего внутренних 
дзен: дзен 
возможность: возможность 
аналитика: аналитика 
план: планах 
ключевой: ключевая ключевых 
каждый: каждому каждым каждого каждый 
факап: факапом 
болеть: болит 
поздний: позже 
дизайнер: дизайнер дизайнера 
группа: группы 
стоимость: стоимость 
курс: курс курсов 
определённый: определенные 
четыре: четыре 
три: трех 
поиск: поиск 
путь: пути путь 
глубоко: глубоко 
сотня: сотен 
качество: качеству 
специфика: специфики 
мониторинг: мониторинга 
редкий: редких 
создавать: создают создавал создает 
проприетарный: проприетарный 
почтовый: почтовый 
избегать: избегать 
карма: карма 
хранилище: хранилища 
взгляд: взгляд 
нравиться: нравился 
тип: типа 
рефакторинг: рефакторинг 
оперативно: оперативно 
мера: мере 
послушать: послушать 
работа: работы работу работ работа работе 
метаданные: метаданные метаданных 
начинаться: начинаются 
запустить: запустил 
случаться: случается 
несколько: несколько 
тратиться: тратится 
набивание: набивания 
подмечать: подмечать 
сегодня: сегодня 
настройка: настройка 
привет: привет 
сожаление: сожалению 
два: двумя 
необходимо: необходимо 
поделиться: поделюсь поделиться 
счастливый: счастливы 
избежать: избежать 
связь: связи связь 
удобно: удобно 
профиль: профиль 
дизраптить: дизраптит 
итеративный: итеративная 
хотеть: хочет хотят хочу 
разный: разного 
тот: тех 
направить: направлены 
начало: начала 
образ: образ 
продакт: продакт продакта продактов 
канал: каналы канал 
значимый: значимых 
успешный: успешен 
старый: старую 
исключительно: исключительно 
баланс: баланс балансе баланса 
опыт: опыта опыт 
её: её 
отрицательный: отрицательный 
проект: проектами проектов 
задуматься: задуматься 
сторона: стороны 
продавать: продавать 
святой: святой 
думать: думаю 
контент: контент контента контентом 
безопасно: безопасно 
искать: ищут 
это: это этим 
выполнение: выполнение 
автоматизированный: автоматизированной 
замечать: замечали 
обойтись: обойтись 
лечить: лечит 
оцифровать: оцифровать 
понятно: понятно 
удобство: удобству удобство 
изменение: изменениями изменений 
рассказывать: рассказывайте 
использование: использования использование 
внешний: внешний внешние внешним 
покупка: покупки покупках 
этап: этапе 
говорить: говорим говорит говорю 
получение: получения 
навредить: навредить 
поддержка: поддержка 
тест: тесты 
рассказать: расскажите расскажу 
банковский: банковские 
корпоративный: корпоративных корпоративные корпоративного 
играть: играют 
быть: е будь будут 
разрабатывать: разрабатываешь разрабатываемыми разрабатывают разрабатываем 
функционал: функционал 
возникнуть: возник возникнуть 
ряд: ряд 
разница: разница 
прийтись: придётся 
почему: почему 
уступать: уступает 
складываться: складывается 
весьма: весьма 
степень: степень 
почитать: почитать 
крупный: крупных 
тема: тема теме 
дать: данной дадим дадите 
создаваться: создается 
развитый: развитый 
способ: способ способы 
хаба: хабы 
вспомнить: вспомнили вспомните 
испробовать: испробовал 
монетизировать: монетизировать 
повысить: повысить 
регулярно: регулярно 
история: истории историю 
прекрасный: прекрасного 
вопрос: вопросов вопросы вопрос 
внутри: внутри 
звать: зовут 
выходить: выходя 
целое: целое целом 
практика: практики практику 
предметный: предметную 
время: времени время 
понимание: понимание 
год: года годом 
подробный: подробное 
аналог: аналог аналогам 
клиент: клиента клиенты 
хороший: хороший хорошие лучшие 
список: список 
сотрудник: сотрудники 
основной: основной 
функциональность: функциональности 
александр: александр 
гарантированно: гарантированно 
замена: замену 
решать: решает решал решать решают 
ящик: ящик 
добрый: добр 
владелец: владельца 
загружать: загружает 
конкретный: конкретных конкретной 
результат: результатов 
повышать: повышая 
пользоваться: пользуются 
зарабатывать: зарабатывает 
начать: начал начнем 
глубинный: глубинное глубинные 
максимальный: максимальная 
среди: среди 
сформировать: сформировать 
набор: набору набор 
обычно: обычно 
следующий: следующим 
тег: теги 
политика: политики 
обратный: обратной обратную 
преодолеть: преодолеть 
открыть: откройте 
уровень: уровень 
привычный: привычный 
ценность: ценности ценность 
кратко: кратко 
прочтение: прочтение 
делать: делаю делать делаешь 
например: например 
происходить: происходить 
кит: китах 
поэтому: поэтому 
дихотомия: дихотомия 
компания: компании компания компаний 
нарисовать: нарисовали 
наблюдаться: наблюдается 
методология: методологий 
идти: идут 
слово: словами слов 
инвестировать: инвестируйте 
ровно: ровно 
мнение: мнение 
качественно: качественно 
стратегия: стратегии 
медиа: медиа 
статья: статья статьи 
рабочий: рабочую 
область: область 
очень: очень 
укладываться: укладывалось 
продвинуть: продвинутые 
приход: приходом 
ты: тебе 
привести: привести приведу 
безразличный: безразлична 
число: числа 
пилить: пилить 
приходить: приходишь 
вызывать: вызывать 
часть: частью 
атрибут: атрибутом 
бывать: бывает 
жить: живет 
получить: получить 
действительно: действительно 
секунда: секунду 
день: день 
интерфейс: интерфейсов 
собственный: собственную собственные 
прислушиваться: прислушиваться 
истёмный: истемный 
событие: событиях 
поставить: поставьте 
спросить: спросите 
особенность: особенностях 
настоящий: настоящее 
фиксировать: фиксированного 
позиция: позиция 
масштаб: масштабах масштаба 
просто: просто 
небольшой: небольших небольшого 
безусловно: безусловно 
место: место 
нормально: нормально 
костыль: костылей 
питание: питания 
пройти: пройдите 
состав: состав 
важно: важно 
глоссарий: глоссарий глоссарием 
всё: всё 
семизначный: семизначные 
наш: наш наши 
снизить: снизить 
категория: категорий 
версия: версию 
товар: товаров 
добавочный: добавочную 
условно: условно 
алертинг: алертинга 
контур: контуре 
бизнес: бизнесе бизнес 
запилить: запилите 
известный: известные 
смотреть: смотрите 
помочь: поможет помогут 
стараться: старайтесь 
метрика: метрикой метрики 
также: также 
инструмент: инструментом инструменты инструмент 
менеджер: менеджер 
запускать: запускали 
проблема: проблемы 
шишка: шишек 
сократить: сократить 
подобный: подобного 
менять: менять 
наиболее: наиболее 
прямой: прямое 
такси: такси 
полноценно: полноценно 
выгодно: выгодно 
создание: создании создания 
настраивать: настраивали 
фотка: фоток 
создать: созданный 
большинство: большинство 
первый: первом 
понять: понял 
чувство: чувство 
заказной: заказной заказную 
сбермаркет: сбермаркета 
инфраструктурный: инфраструктурных 
лежать: лежат 
масштабироваться: масштабируется 
библиотека: библиотеки 
комментировать: комментировать 
приоритетный: приоритетных 
учебный: учебных 
достаточно: достаточно 
процесс: процесс процессов 
нотификация: нотификация нотификации 
краткость: краткости 
слой: слой 
ответить: ответить 
анализ: анализ 
управлять: управлять 
привлечение: привлечение 
какой: какие 
фильтровать: фильтровать 
мой: моим моих мою 
скучный: скучный 
произойти: произошло 
поверхность: поверхности 
хотеться: хотелось 
взаимодействовать: взаимодействуйте 
фича: фичами фичей 
статистика: статистику 
неотъемлемый: неотъемлемым 
они: ими ними 
информация: информацию 
пункт: пунктом пунктов 
почта: почту 
подойти: подойдет 
дело: дело 
увеличивать: увеличивать 
средний: среднее 
закончить: закончу 
мина: мин 
количественный: количественные 
позволять: позволяют 
текст: текст 
потерять: потерять 
экономика: экономика 
давать: давайте 
экономить: экономят 
сталкиваться: сталкивались 
сутки: сутки 
стоящий: стоящие 
вид: вида 
разложить: разложить 
гипотетически: гипотетически 
показывать: показывают 
снижать: снижать 
тд: тд 
самый: самое 
крутой: крутой 
интервью: интервью 
мир: мир 
пытаться: пытаясь 
вакансия: вакансии вакансий 
статистически: статистически 
домен: домене 
выше: выше 
входящий: входящих 
грааль: грааль 
помогать: помогает помогают 
ежедневный: ежедневную 
данные: данных 
стать: стать 
боль: боль 
туда: туда 
стабильно: стабильно 
примерно: примерно 
временной: временные 
благо: благо 
изображение: изображений 
пример: примерах пример 
вроде: вроде 
рейтинг: рейтинг 
поднимать: поднимаю 
вы: вами 
другой: другие другому других 
всякий: всякий 
враг: врагов 
улучшить: улучшить 
развивать: развивайте 
популярный: популярных 
технический: техническая 
дублировать: дублировать 
храниться: хранящегося 
креатив: креативы 
дть: демо 
роль: роли 
заполнить: заполненные 
ежедневно: ежедневно 
быстрый: быстрые 
прийти: пришел 
вариант: вариантов 
оставлять: оставляйте 
дополнительный: дополнительную 
закладка: закладки 
пожалуй: пожалуй 
видео: видео 
брать: берут 
продуктовый: продуктовым продуктовая продуктовых 
выделение: выделение 
впечатление: впечатление 
вернуться: вернуться 
отрасль: отрасли 
дискорд: дискорде 
многие: многие 
измерить: измерить 
человек: человек 
эффективно: эффективно 
сопротивление: сопротивление 
пропасть: пропасть 
внедрять: внедрять 
хабра: хабр 
программа: программы 
любой: любой 
сложность: сложности 
дом: дома 
видеть: видеть 
решить: решит 
кавычка: кавычках 
позволить: позволит 
обновить: обновить 
надеяться: надеюсь 
показ: показ 
сумма: суммы 
зажить: заживут 
упустить: упустить упустили 
аналитик: аналитик 
иконка: иконок 
саша: саша 
эффективность: эффективность 
стоить: стоит 
просмотр: просмотров 
публикация: публикации 
валидация: валидация 
никакой: никаких 
так: т 
однажды: однажды 
узнать: узнать узнал 
мало: мало 
некий: некое некая 
тысяча: тысяч тысячи 
инкремент: инкремента 
объём: объема 
провести: проведя 
автоматизация: автоматизация 
уверенный: уверен 
понятный: понятна 
предлагать: предлагаю 
обязательно: обязательно 
своевременный: своевременную 
баннер: баннеров 
порассуждать: порассуждать 
кампания: кампании 
кастдев: кастдевов 
резюме: резюме 
счёт: счет 
подкаст: подкасты 
сторонний: сторонний 
прогнозировать: прогнозируемые 
казаться: казалось 
разногласие: разногласий 
расход: расходы 
половина: половины 
известно: известно 
быстро: быстро 
влияние: влияние 
попробовать: попробуем 
закрепить: закрепим 
прибыль: прибыль 
сосредоточиться: сосредоточился 
мара: мар 
пара: пару 
эксперимент: эксперимента 
вместе: вместе 
вообще: вообще 
сначала: сначала 
столь: столь 
самописный: самописная 
куча: куча 
