оказаться: оказаться оказался 
материал: материалов 
система: системе системой система системах системы систему 
мочь: могут 
раздобыть: раздобыть 
модицикация: модицикацией 
тестовый: тестового 
задача: задачи 
эксплойтаха: эксплойтах 
простой: простых проще простой 
реальный: реальных 
утилит: утилиты 
колесников: колесников 
удобство: удобства 
являться: является являются 
путём: путем 
сервис: сервиса сервис 
поле: поле 
злоумышленник: злоумышленники 
бесплатный: бесплатными бесплатный 
действие: действия действий 
дождаться: дождаться 
файловый: файловой файловые файловых 
атака: атаки атака атаках атак атаку 
яндекс: яндекс 
вектор: вектора 
выбирать: выбирать 
менна: менне 
получиться: получится 
реализовать: реализованы реализована 
право: права 
выполняться: выполняются выполняться выполняется 
нужда: нужды 
запуск: запуском 
эксплойт: эксплойта эксплойт эксплойты 
перемещение: перемещение 
комментарий: комментарии 
пользователь: пользователям пользователя пользователь пользователей 
голос: голосов 
чёткий: четкого 
инфраструктура: инфраструктуре инфраструктуры инфраструктуру инфраструктура 
тактика: тактики тактику тактика тактик 
дмитрий: дмитрий 
меню: меню 
читатель: читателю 
должный: должны должна 
гипотеза: гипотезы 
боковой: боковое 
патч: патч 
автор: автор 
взять: возьмем 
популярный: популярными популярных 
восстанавливать: восстанавливать 
зарегистрироваться: зарегистрироваться 
механизм: механизмы механизма 
учётный: учетной учетных учетным 
взаимодействие: взаимодействие 
начать: начать начал 
переходить: переходить 
набор: наборы набора набор 
объём: объеме 
собственный: собственной 
речь: речь 
чель: чели 
добавить: добавить добавим 
номер: номерами номером 
очередь: очереди 
точно: точно 
знание: знания знаний 
помощь: помощью 
потребовать: потребовал потребовать 
нужно: нужно 
подключение: подключения подключение 
находиться: находятся находится 
условие: условие условия условий 
случай: случаях случае 
поиск: поискам поиск поиска 
самостоятельный: самостоятельной 
вид: виде 
пара: пары 
сделать: сделать 
язык: языка язык 
набрать: набрать 
требоваться: требуется 
который: которые которым которая которых который которую которого 
пароль: паролей пароли пароль пароля 
требовать: требует требуют 
дзен: дзен 
подзапустить: подзапустили 
возможность: возможность возможности 
атаковать: атакующего 
особенный: особенным 
итог: итоге 
тестирование: тестированию тестирования 
реализоваться: реализуются реализуется 
административный: административные 
тот: те 
использовать: использовать использует используя 
шар: шары шар шаре 
реализация: реализации 
карма: карма 
открытый: открытом 
работа: работы работу 
большой: большом 
рабочий: рабочее 
поисковик: поисковиком 
свой: свои 
операционный: операционной операционная операционную 
наверное: наверное 
нахождение: нахождения 
найти: найдены найти 
единственный: единственным 
настройка: настройка 
предоставляться: предоставляется 
место: места место 
возникать: возникает 
необходимо: необходимо 
стать: статей стать 
навык: навыки 
профиль: профиль 
безопасность: безопасность 
маленький: меньше 
ситуация: ситуация 
протокол: протокол 
образ: образ 
стенд: стенда 
привелегировать: привелегированного 
самый: самый самое 
тестировать: тестировать 
старый: старую 
дать: даст данные 
сеть: сети 
этот: этому 
применение: применение 
меть: менет 
установить: установим установлен 
её: её 
информационный: информационные информационная 
привелегия: привелегии 
контент: контент 
ограничить: ограничен 
включить: включена 
это: это 
подготовка: подготовки 
подходить: подходят 
запись: записям записях записи записей 
доступный: доступен 
использование: использования использование 
команда: команды команде 
любой: любую 
особый: особых 
вирусный: вирусный 
получение: получения 
поддержка: поддержка 
обзор: обзор 
котроллер: котроллера 
подсистема: подсистему 
сам: сами 
локальный: локальной 
древний: древними 
выполнить: выполнены выполнить 
предпринять: предпринять 
пентест: пентеста пентест 
функционал: функционал функционалом 
распоряжение: распоряжении 
маркетолог: маркетолог 
продакшен: продакшене 
меняться: меняться 
валидной: валидной 
техника: техники 
хаба: хабы 
способ: способ способы способом способами 
проводить: проводить проводят 
подключаться: подключаемся 
виртуальный: виртуальной 
предлагаться: предлагается 
повысить: повысить 
подряд: подряд 
база: базу баз 
стараться: старается 
этап: этапу 
внутри: внутри 
предположение: предположений 
время: времени время 
строй: строя 
список: список списка 
полноценный: полноценной 
александр: александр 
логинов: логинов 
собирать: собирать 
печать: печати 
владелец: владельца 
конкретный: конкретных 
качество: качестве 
остальной: остальное 
изучить: изучить изученных изучим 
среди: среди 
идти: идет 
обычно: обычно 
тег: теги 
каждый: каждым 
какой: каких 
уровень: уровень 
оказываться: оказывается 
внутренний: внутренней 
конфигурация: конфигурация 
прочтение: прочтение 
хранилище: хранилищах 
систематизировать: систематизированы систематизировать 
сбор: сбора сбор 
поэтому: поэтому 
искать: ищем искать 
максимально: максимально 
компания: компании 
продолжить: продолжить 
статья: статье статьи 
успех: успеха 
проникновение: проникновения проникновение 
выполнять: выполнять выполняют 
полезно: полезно 
повлеся: повлесь 
один: одна 
очень: очень 
продвинуть: продвинутые 
включать: включает 
теряться: теряться 
помочь: помочь 
бащий: баще 
получить: получить 
правильный: правильной 
запустить: запущен запустить 
знать: знаем 
некоторый: некоторых 
исполняемый: исполняемый 
просто: просто 
исходный: исходных 
такой: таком 
обучение: обучении 
важно: важно 
выполнение: выполнения 
гиппотеза: гиппотез 
затем: затем 
версия: версию 
процедура: процедуре 
основный: основного 
наш: наши 
платформа: платформе 
необходимый: необходимы 
перебор: перебором 
делегация: делегация 
пользоваться: пользоваться 
инструмент: инструментом инструменты инструментов инструмент инструментами 
учеткать: учетку 
головин: головин 
препятствие: препятствием 
заложить: заложен 
наиболее: наиболее 
серевера: сереверу 
мы: нам 
анонимный: анонимного 
ос: ос 
прийтись: придется 
комментировать: комментировать 
ведущий: ведущих 
максимальо: максимальо 
завершение: завершение завершения 
достаточно: достаточно 
процесс: процесс 
заработать: заработала 
хороший: лучшие 
аутентификация: аутентификации 
вчера: вчера 
активный: активных 
привилегия: привилегий 
сайт: сайт 
подход: подходы 
неприличный: неприличного 
старт: старта 
доступ: доступа доступ 
пристальный: пристального 
мина: мин 
позволять: позволяют 
формат: формата 
исследователь: исследователей 
работать: работает работать 
суть: сути 
сутки: сутки 
внимание: вниманием 
проект: проекта 
логин: логина 
сложный: сложные 
скрипт: скрипт скрипты 
весь: всем 
урок: урок 
затрачивать: затрачивать 
админ: админа 
выше: выше 
хранение: хранение 
быть: будем будут 
данные: данных 
пример: примерах примеров 
немного: немного 
информация: информации 
рейтинг: рейтинг 
изучение: изучения 
позволить: позволят 
отличить: отличить 
вконтакте: вконтакте 
стандартный: стандартным стандартные 
перечисленный: перечисленные 
неограниченный: неограниченная 
технический: техническая 
разрозненный: разрозненных 
отсутствие: отсутствие 
больший: большим 
отдельно: отдельно 
беглый: беглым 
количество: количество 
репозиторий: репозиторий 
называть: называемое 
домен: домена 
либо: либо 
закладка: закладки 
контроллер: контроллер контроллера 
опыт: опытом 
проводиться: проводились 
похожий: похожие 
вернуться: вернуться 
раздуть: раздули 
хабра: хабр 
сложность: сложности 
сразу: сразу 
успешный: успешного 
произвести: произвести 
минимальный: минимальный 
обновить: обновить 
воспользоваться: воспользоваться 
машина: машины 
аналитик: аналитик 
ценный: ценное 
просмотр: просмотров 
публикация: публикации 
сообщество: сообществе 
файл: файл 
помнить: помнить 
последний: последняя 
загрузить: загрузить 
намного: намного 
быстрый: быстрыми 
вести: вести 
заставить: заставить 
эксперт: экспертов 
предоставление: предоставления 
развёртывание: развертывания 
счёт: счет 
исследование: исследования 
проведение: проведения 
цифровой: цифровые 
спектр: спектром 
собрать: собрать 
пользовательский: пользовательским 
блог: блог 
попробовать: попробуем 
быстро: быстро 
приглашать: приглашаю 
слабый: слабые 
создание: создания 
основной: основные 
выход: выход 
уязвимость: уязвимостей 
обычный: обычное 
вообще: вообще 
особенность: особенности 
противный: противном 
сначала: сначала 
указанный: указанного 
производиться: производится 
