повторить: повторить 
весь: весь 
мочь: могут 
бросать: бросать 
указатель: указателей указатель указатели 
версия: версиях версию 
пройти: пройдены 
изменять: изменять 
общий: общего 
увы: увы 
прежний: прежнему 
вызываться: вызывается 
конвертация: конвертации конвертация 
вывод: вывод вывода 
оставить: оставлю 
удобство: удобства 
понять: поняли 
применение: применения применение 
байт: байтов 
поле: поле полей полями поля 
замечательный: замечательно 
действие: действия действиями 
внимание: внимание 
яндекс: яндекс 
обработка: обработки 
особенность: особенность 
получиться: получится 
метод: методы метода метод методами методах методов 
значение: значение значения значению 
выравнивание: выравнивание выравнивания 
содержание: содержание 
испытать: испытать испытаем 
брать: берём 
консоль: консоли 
подходить: подходит 
полный: полной полного 
разрешение: разрешением 
строка: строка 
комментарий: комментарии 
удаться: удастся удалось 
экземпляр: экземпляры экземпляре экземпляра 
класс: класс классы класса классах классе классов 
вызов: вызове 
напечатать: напечатал 
меню: меню 
посмотреть: посмотреть 
совпадать: совпадали совпадает совпадают 
сложный: сложный 
андроид: андроид андроида 
несложный: несложными 
опробовать: опробовать 
часть: часть части 
программист: программист 
связанный: связанно 
размер: размер 
познакомиться: познакомились 
пользовательский: пользовательских 
странный: странный 
мелочиться: мелочиться 
прошлый: прошлой 
именно: именно 
поведение: поведение 
порядок: порядок порядка 
часто: часто 
исключение: исключений исключением 
дело: деле 
сравнение: сравнением 
свой: свой свои 
храниться: хранятся 
имя: именем именами имя 
добавить: добавить 
тестовый: тестовом 
сообщение: сообщение 
начало: начало начала 
точно: точно 
хранить: хранит хранимых храня 
зависеть: зависит 
сам: самом сами 
непосредственный: непосредственное 
исполнение: исполнение 
инициализировать: инициализированным 
вм: вм 
ы: ы 
видно: видно 
нужно: нужно 
удостовериться: удостовериться 
макет: макеты 
считать: считать 
находиться: находятся 
битый: бит 
иметь: имеют имеет иметь 
получать: получаем 
вид: виде вид 
простой: проще 
сделать: сделать 
язык: языка языками языках языке язык 
модификатор: модификатором модификаторы модификатор 
скармливать: скармливаем 
который: которые который которое которого 
шаг: шаг 
требовать: требует требуют 
структура: структуры структуру 
дзен: дзен 
реализация: реализация реализацию 
присваивать: присваивает 
поздний: позже 
положительный: положительное 
предназначение: предназначения 
поиск: поиск 
двойник: двойников двойники двойниках 
обратить: обратим 
экономно: экономно 
использовать: использовать используемые 
лишь: лишь 
битный: битных 
содержать: содержат содержит 
описывать: описывающие описывающего 
карма: карма 
написание: написание написания 
внимательно: внимательно 
совершенно: совершенно 
второй: второй второго вторая 
ситуация: ситуациях 
несколько: несколько нескольких 
небезопасный: небезопасный 
далее: далее 
близкий: ближайших 
победа: победа 
проблема: проблема 
настройка: настройка 
выделить: выделен 
необходимо: необходимо 
найти: нашёл найти 
профиль: профиль 
некорректный: некорректные 
зависимость: зависимости 
быть: буду будем будут 
маленький: меньше 
знакомый: знакомые 
означать: означает 
деление: деление 
вывести: выведенная вывели 
падение: падению 
остаться: осталось остался 
представлять: представляют 
статический: статический статические 
самый: самый 
ограничение: ограничение 
рабочий: рабочим 
системный: системных 
код: кода код коде 
старый: старую 
этот: этому этих 
предыдущий: предыдущей предыдущих 
раз: раза 
стандартный: стандартной 
название: названием 
создавать: создаём создавать создаёт 
наличие: наличие 
повторение: повторения 
это: это этим 
разный: разными разных 
знание: знание 
ом: ом 
заметить: заметить заметили 
аппаратный: аппаратные 
первый: первого первая первое первый 
интерпретировать: интерпретировать 
тест: тестов тесты 
расставить: расставленными 
будущий: будущих 
пора: пора 
разрядность: разрядности 
объект: объекте объектов объект объекты 
получение: получения получение 
поддержка: поддержка 
пример: примеры 
ряд: ряд 
один: одном одно 
сравнить: сравнить 
почему: почему 
позволять: позволяет 
хаба: хабы 
должный: должен 
справиться: справились 
узнать: узнали узнать 
заметка: заметка 
рассказать: расскажу 
профильтровать: профильтровать 
минута: минут 
взять: взять 
образ: образом 
выглядеть: выглядит 
пригодиться: пригодится 
пользователь: пользователь 
список: список списка 
нулевой: нулевыми нулевому 
практика: практике 
произойти: произойдёт произошло 
ещё: ещё 
смещение: смещение 
процедура: процедура процедуру 
дальнейший: дальнейшие 
вызвать: вызвать 
поступить: поступим 
снова: снова 
помнить: помните 
тег: теги 
подсмотреть: подсмотреть 
скопировать: скопировать 
целочисленный: целочисленные 
верхний: верхнее 
уровень: уровень 
идентичный: идентична 
прочтение: прочтение 
префикс: префикс 
специальный: специальным специальный 
наследоваться: наследуется 
поэтому: поэтому 
материализовать: материализовать 
статья: статье статьи 
счастие: счастью 
смениться: смениться 
механизм: механизмами механизма 
очень: очень 
обычный: обычного обычный 
небольшой: небольшой небольшое 
лямбда: лямбду 
число: числа число 
вызывать: вызывать 
человек: люди 
получить: получить 
константный: константный 
действительно: действительно 
виртуальный: виртуальная 
работоспособность: работоспособности 
готовый: готовые готовое готовом готовый 
знать: знаем 
момент: моментов момент 
самостоятельный: самостоятельное 
исходный: исходном исходный 
просто: просто 
такой: такого таком 
всё: всё 
отступ: отступ 
назад: назад 
использование: использовании 
затем: затем 
байткод: байткоде 
прекрасный: прекрасный 
смотреть: смотрит 
упоминать: упоминал 
конструктор: конструктора конструктор конструкторы конструкторов 
пользоваться: пользуется 
защита: защиты 
также: также 
догадаться: догадаются 
данный: данного 
зато: зато 
явление: явления 
ненормальный: ненормальное 
мы: нам 
процессор: процессора 
история: истории 
возвращать: возвращаемый 
тип: тип типами типы 
основный: основную 
необходимый: необходимое 
расстановка: расстановку расстановки 
реально: реально 
библиотека: библиотеки 
отделить: отделив 
комментировать: комментировать 
создание: создание 
достаточно: достаточно 
конец: концу 
лежать: лежит 
интересовать: интересующую 
требование: требование 
управлять: управлять 
практически: практически 
монстр: монстра 
переменный: переменным 
упомянуть: упомянуто 
хороший: лучшие 
отступление: отступление 
место: местах 
забавно: забавно 
отметить: отметить 
мина: мин 
решение: решение 
кодобред: кодобред 
он: нём 
давать: давайте дают 
работать: работает работать 
факт: факт 
сутки: сутки 
меняться: меняется 
инициализация: инициализации 
некий: неким 
машина: машина машинах 
разработчик: разработчик 
картина: картины 
функция: функцию 
любой: любых 
видоизменить: видоизменённые 
вакансия: вакансии вакансий 
эксперимент: эксперименты 
выше: выше 
влиять: влияют 
тот: теми 
данные: данных 
залезать: залезаем 
вмещать: вмещает 
выделиться: выделятся 
наслать: нашли 
рейтинг: рейтинг 
определённый: определённым 
каждый: каждый 
два: двух 
далёкий: дальше 
разработка: разработка 
введение: введение 
технический: техническая 
полностью: полностью 
отсутствие: отсутствие 
отдельно: отдельно 
количество: количество 
вызваться: вызвался 
ах: ах 
проверка: проверка 
обёртка: обёртка 
либо: либо 
уметь: умеет 
довольно: довольно 
отличаться: отличается 
закладка: закладки 
что: чём 
написать: напишем 
программирование: программирование 
математический: математическими 
похожий: похожие 
вернуться: вернуться вернулся 
показывать: показывает 
перевести: перевести 
себя: собой 
наследовать: наследуют 
хабра: хабр 
работа: работа 
проходить: проходит 
сложность: сложности 
охотно: охотно 
внутренний: внутренних 
останавливаться: останавливаться 
главное: главное 
практический: практического 
потенциально: потенциально 
обновить: обновить 
вытащить: вытащить 
правильность: правильности 
проявиться: проявилась 
использоваться: используется 
время: время 
читать: читают 
дать: данные 
трогать: трогал 
заранее: заранее 
массив: массив 
никак: никак 
значит: значит 
другой: другое других 
основа: основе 
стоить: стоит 
просмотр: просмотров 
публикация: публикации 
численный: численное 
осуществляться: осуществляется 
набор: набор 
описание: описанием 
нативный: нативных 
половина: половина 
обернуть: обернуть 
знаток: знатокам 
печатать: печатает 
насильно: насильно 
присваиваться: присваивается 
городить: городить 
приводить: приводят 
логика: логику 
известно: известно 
штатный: штатный 
попробовать: попробуем 
интересный: интересного 
очевидный: очевидным 
козелки: козелков 
новый: новый 
владимир: владимир 
видеть: видим 
сначала: сначала 
условный: условное 
