выше: выше 
система: системе 
материал: материалов 
удивительно: удивительно 
распределение: распределении 
мегапьютер: мегапьютер 
системный: системный 
очень: очень 
профиль: профиль 
данные: данных данным 
молодёжь: молодежь 
вывод: вывод 
промышленность: промышленность 
москва: москву москвы москве 
профессиональный: профессионального 
туда: туда 
лёгкий: легкая 
образование: образованию образованием образование 
алексей: алексей 
строительный: строительных 
город: городах города городов 
шеф: шеф 
крупный: крупные 
подводить: подводя 
топ: топ 
машинный: машинное 
профессия: профессиям профессия профессий профессии 
рейтинг: рейтинг 
позиция: позиции позиций позициям 
столичный: столичных 
праздник: праздника 
маленький: мал 
яндекс: яндекс 
запрос: запросы 
технология: технологий 
популярный: популярных популярные популярны 
технический: техническая 
невероятно: невероятно 
повар: повар 
пять: пяти 
старый: старую 
количество: количество 
мужской: мужские мужским мужских 
водитель: водителя водителем водитель 
итог: итоги 
два: двум 
тенденция: тенденции 
интересный: интересная 
вышеизложенный: вышеизложенного 
мастер: мастер 
выделить: выделил 
сфера: сфера 
комментарий: комментарии 
регион: регионах регионе 
наш: наш 
голос: голосов 
назад: назад 
отличаться: отличается отличалась 
высокий: высшим высшее 
цех: цеха 
закладка: закладки 
простой: простой 
инженер: инженер инженера 
опыт: опытом опыту опыт 
версия: версию 
загрузить: загрузив 
процент: процента 
меню: меню 
зарплата: зарплата зарплате 
остальной: остальных 
похожий: похожие 
вернуться: вернуться 
это: это 
смена: смену смены 
машиностроение: машиностроение 
представитель: представители 
график: графиков 
стать: стало стали 
лидер: лидеров 
также: также 
хабра: хабр 
мужчина: мужчин мужчины мужчина 
работа: работа работы 
вакансия: вакансий вакансии 
менеджер: менеджер менеджера 
сложность: сложности 
этап: этапе 
кандидат: кандидат 
поддержка: поддержка 
обучение: обучение 
сравнительный: сравнительный 
транспортный: транспортное 
петербург: петербурга петербург петербурге 
получиться: получилась 
управлять: управляющий 
обновить: обновить 
выбирать: выбираем 
плюс: плюсом 
разница: разница 
время: время 
хотеться: хочется 
дать: данные 
первый: первом 
среднестатический: среднестатический 
поиск: поиску поиск 
развить: развита 
добавить: добавить 
аналитик: аналитик 
тверь: тверь твери 
язык: язык языка 
год: году лет года 
юрист: юрист юриста 
программа: программе 
должностной: должностного 
средний: средний среднему 
хаба: хабы 
современный: современные 
оставаться: оставаться 
разгуляться: разгуляться 
попадать: попадают 
такой: такие таким 
стоить: стоит 
столица: столице столица 
просмотр: просмотров 
доход: доходом 
показать: показал 
будущий: будущей 
публикация: публикации 
химический: химическая 
специальность: специальности 
возможность: возможности 
интересно: интересно 
наука: наук 
источник: источник 
так: т 
песочница: песочницы 
преддверие: преддверии 
анализ: анализ 
иметь: имеют имеющий 
какой: какие 
история: истории 
ранний: раньше 
производство: производстве производств 
хороший: лучшие 
выбор: выбор 
сделать: сделать 
иваново: иваново 
новый: новые 
получаться: получается 
пользователь: пользователь 
рамка: рамки 
периферия: периферии 
статистика: статистика 
основной: основной основные 
показатель: показатель 
дзен: дзен 
лидировать: лидирует 
основный: основная основным 
сфокусировать: сфокусированы 
они: ими 
задуматься: задумался 
совпадение: совпадения 
отталкиваться: отталкиваясь 
развитие: развития 
провести: проведем провел 
возраст: возраст 
целое: целом 
пищевой: пищевая 
отметить: отметить 
приходить: приходят 
резюме: резюме 
мина: мин 
тройка: тройке тройка 
среди: среди 
уровень: уровнем уровень 
сервис: сервисе 
взять: взял 
лишь: лишь 
идти: идет 
стремиться: стремиться 
экономический: экономического 
тег: теги 
критерий: критериям 
рост: роста 
карма: карма 
сутки: сутки 
одинаковый: одинаковая 
самый: самые 
ниже: ниже 
санкт: санкт 
известно: известно 
возрастной: возрастные 
прочтение: прочтение 
начальник: начальник 
торговый: торговая 
отслеживать: отслеживать 
замыкать: замыкает 
соискатель: соискатели 
многий: многим 
разработчик: разработчик 
поэтому: поэтому 
администратор: администратор 
актуальный: актуальны 
мара: мар 
место: месте 
полвека: полвека 
компания: компании 
решить: решил 
кладовщик: кладовщик 
далее: далее 
особенно: особенно 
сковывать: сковывали 
десятка: десятку 
специалист: специалиста специалист 
участок: участка 
работать: работать 
мир: мир 
настройка: настройка 
малоразвитый: малоразвитых 
