логика: логика логику 
говориться: говорилось 
угол: угла угол углы углу углом 
частота: частотой 
настоящий: настоящего настоящие 
оставить: оставлю оставить 
расстояние: расстояний расстояния расстоянии расстояние 
координата: координату координатах координаты координат координатам 
область: области область 
друг: друга другом друг 
поскольку: поскольку 
невероятно: невероятно 
значение: значение значений 
память: памяти память 
смотреть: смотрим смотрят смотреть см смотрит 
головной: головного 
аппроксимация: аппроксимации аппроксимация аппроксимацию 
перемещение: перемещение перемещении перемещения перемещениях 
спецификация: спецификации 
называть: называемого называю 
запрещать: запрещает 
свойственный: свойственных 
дружелюбный: дружелюбным 
указатель: указатель указателей 
мочь: мог можем можете могли 
безопасность: безопасности 
сравнивать: сравнивает 
рядом: рядом 
часто: часто 
меняться: меняются меняется 
дело: деле дело делом 
среда: среду среда 
библиотека: библиотеке библиотеки библиотеку библиотека 
ввод: вводом ввод 
цвет: цвет цвета 
число: чисел числе число числа 
начинать: начинал 
вызов: вызов вызовы вызове 
иметь: имеют имеет 
определять: определяющих определяемую 
доступный: доступным 
точка: точками точка точки точке 
шаг: шаг 
различие: различия 
требовать: требует 
схема: схема схеме 
единственный: единственных единственный единственное единственную 
статья: статью статьи 
бумага: бумагу 
изгибаться: изгибаются 
поздний: позже 
имитация: имитацией 
наш: нашим нашу наш нашем нашего нашей наша 
рейкастинг: рейкастинга рейкастинг рейкастингом 
переводчик: переводчик 
перспектива: перспективе перспективу перспективы 
ограничение: ограничениями ограничений ограничения 
реализация: реализации реализацию реализацией реализация 
работа: работы работа работой 
сложный: сложная сложное сложнее сложную 
ситуация: ситуациях ситуации 
несколько: несколько 
плоскость: плоскость 
далее: далее 
доскочить: доскочит 
проблема: проблема проблемы 
исправление: исправление 
сделать: сделал сделать сделаем сделаю 
скачать: скачать 
устроить: устроена 
выпуск: выпуска 
вымышленный: вымышленной 
маскирование: маскирования 
собирать: собирайте 
программа: программу программы программе программа 
линия: линия линий линии линию линиях 
создавать: создавая создавал создаёт создавать 
минимум: минимуму 
измерение: измерениях 
пересечение: пересечения пересечений пересечениями пересечениях 
любить: люблю 
поместить: поместим 
понятный: понятнее понятным 
предыдущий: предыдущей предыдущий предыдущего 
просить: просит 
тригонометрия: тригонометрии 
название: названием названии 
наподобие: наподобие 
чрезвычайно: чрезвычайно 
возможность: возможностей 
обещать: обещал 
графический: графического графических 
говорить: говоря говорит 
написать: написали написать напишу написал напишем 
луч: лучей луч лучи луча 
применить: применить 
заметить: заметить заметите заметили 
отрисовка: отрисовки отрисовкой отрисовку отрисовка 
команда: команды командами команд 
итог: итог 
лежать: лежащий 
пиксель: пикселях пикселей 
записать: запишем 
передать: передать 
особо: особо 
показать: показать покажу 
почему: почему 
приказывать: приказывающие 
привязывать: привязывает 
постараться: постарался 
скомпилировать: скомпилируем 
предложить: предложило 
человек: человека людей люди 
следующий: следующие следующее 
разбираться: разбираться разбираетесь 
получиться: получилось получился 
использование: использование использованием 
внутри: внутри 
надёжный: надёжное 
внести: внесём 
состояние: состояние состояний состояния 
список: список 
основный: основная 
умолчание: умолчанию 
низкий: низкую 
остальной: остальное 
рисовать: рисует рисовать 
начаться: началась начались 
хотеть: хотим хотите 
открыть: открыли 
пересмотреть: пересмотрим 
ресурс: ресурсов 
игра: играх игра игры игре игр играми игру 
находиться: находящейся находимся находится 
делать: делаю делаем делать 
прежде: прежде 
целочисленный: целочисленных 
поэтому: поэтому 
максимально: максимально 
сильно: сильно 
ого: ого 
основа: основ основе основой основы 
сборка: сборка сборки 
запуск: запуска 
полный: полного 
карта: карту карты карта картах 
насколько: насколько 
готовый: готов 
сколько: сколько 
объединить: объединить объединим 
решить: решить 
интервал: интервале интервалами 
позиция: позиция позиций позиции 
такой: такого такими такие таком такая 
добавлять: добавляет 
окно: окнами окне окно окна окон 
импортировать: импортировали импортируем импортировать 
выполнение: выполнения выполнении 
казаться: кажется казался казалось 
реальный: реальном реальный реальной 
средний: средней средний 
какой: каким какие 
испускать: испускающей 
придумывать: придумывать 
писать: писали пишем писать 
удалённый: удалённые 
стиль: стиле 
малый: малой наименьший меньшей меньшее малое 
оптимизировать: оптимизируем оптимизировать 
уникальный: уникальный 
уменьшение: уменьшения 
использовать: используемый использованы использовать использует используем 
начало: начале начало начала 
экран: экран экрана экране 
предел: пределов 
объяснить: объясню 
история: истории 
первый: первой первого первых первую первые первый первым 
крейт: крейт крейта 
клавиатура: клавиатура клавиатуре клавиатуры 
ограниченный: ограниченная 
действовать: действовать 
прийтись: пришлось придётся 
взаимодействовать: взаимодействовать 
вчера: вчера 
неотъемлемый: неотъемлемых 
ранее: ранее 
подойти: подошёл 
приличный: приличное 
одновременно: одновременно 
реализовать: реализует реализуем реализовать 
рендериться: рендерится 
ползать: ползать 
паттерн: паттерны паттерн 
удаление: удаления 
он: нём нему 
вывод: вывода вывод 
связанный: связанных 
сутки: сутки 
самый: самая самое 
решать: решаем решает 
этот: этих эта этому 
кнопка: кнопку кнопки 
вертикальный: вертикальной вертикальную вертикального вертикальных вертикальные вертикальная 
запись: записи 
знак: знаком 
быть: будем будут буду 
заменить: заменили 
постоянно: постоянно 
близкий: ближайшей близкие ближе ближайшего 
далёкий: далёкие дальше 
незаметный: незаметны 
поверх: поверх 
версия: версии версию 
рейтинг: рейтинг 
горизонтальный: горизонтального горизонтальные горизонтальных горизонтальную горизонтальными 
минимизация: минимизации 
четыре: четырёх четыре 
ночной: ночной ночная 
один: одной одна одним 
введение: введение 
строка: строку 
передавать: передаём передавала передавать передаёт 
сложно: сложно 
весь: всеми 
неточно: неточно 
просмотр: просмотра просмотров 
оз: озу 
запуститься: запустится 
отдельность: отдельности 
юг: юг 
довольно: довольно 
неплохо: неплохо 
фрилансер: фрилансер 
вернуться: вернуться 
небольшой: небольшое небольшой 
поле: поля 
ощущение: ощущение 
цена: ценой 
вакансия: вакансий вакансии 
сложность: сложности 
останавливаться: останавливаться останавливаются 
бесконечно: бесконечно 
позволить: позволит 
обновить: обновить 
тот: той те тому тех 
использоваться: используется 
время: время времена времени 
операция: операции 
принимать: принимать 
компилировать: компилируемых компилировать 
стоить: стоит 
публикация: публикации 
файл: файл файлы файлов файла 
расширить: расширить 
платформа: платформу 
приказать: прикажет 
намеренно: намеренно 
пост: пост посте 
исполнение: исполнения 
дизайн: дизайна 
собрать: собрать 
разделить: разделить 
продление: продлениями продлений продление продления 
желание: желании 
вычислить: вычислить вычислили 
битый: биты битом 
зрение: зрение зрения 
состоять: состоящей состояли 
обозначать: обозначать 
вероятно: вероятно 
простой: простые простых простую простому простейших простым простом простая проще простой 
вверх: вверх 
допустить: допустим 
яндекс: яндекс 
сходиться: сходится 
заглянуть: заглянете 
будущее: будущем 
булев: булево 
подходить: подходит 
расплывчатый: расплывчатое 
ошибочно: ошибочно 
знать: знаете знал знает знаем знаю знать зная 
комментарий: комментарии 
голос: голосов 
столбец: столбец столбца 
посмотреть: посмотреть 
часть: часть частей части 
сенсорный: сенсорный 
рыбий: рыбий рыбьего 
одинаковый: одинаковую 
именно: именно 
понимать: понимаете 
начать: начать начал начнём 
ориентация: ориентации 
решение: решением решение решению 
указать: укажу 
призывать: призываю 
флаг: флаги 
записывать: записывает записывая записывать 
постоянный: постоянна 
сам: самом самим сами 
вдаваться: вдаваться 
понятие: понятия 
выполнить: выполните 
идея: идея 
повернуть: повёрнутые 
тень: тенью тени теням 
испустить: испустить 
перевернуть: перевёрнута 
нажатие: нажатии 
специально: специально 
поиск: поиск поиска 
разбить: разбить 
описывать: описывающие описывают 
точный: точное точной 
настраивать: настраиваемых 
мышь: мышь 
вызывать: вызывает вызывать вызывая 
тип: типа 
косинус: косинус 
свой: свои своего 
принцип: принцип 
оптимизация: оптимизации 
выполнять: выполняет выполняющий выполнять 
отображение: отображением 
сегодня: сегодня 
настройка: настройка 
движок: движка движок движком 
проверить: проверите 
изящный: изящным 
зарезервировать: зарезервировать 
максимальный: максимальный 
правильно: правильно 
равный: равна 
пространство: пространства пространство 
трассировать: трассирует 
вводить: вводить 
уровень: уровне уровни уровень 
перпендикулярный: перпендикулярная 
задонатить: задонатить 
программирование: программирования 
мир: мире 
алгоритм: алгоритмы алгоритма алгоритм алгоритму 
вперёд: вперёд 
её: её 
описать: описанный 
объяснение: объяснение объяснения 
безопасно: безопасно 
это: это этим 
знание: знание 
оставлять: оставляет 
деталь: детали 
сохранение: сохранение сохранении 
текущий: текущей текущее 
величина: величину 
общий: общую общее общие 
фундаментальный: фундаментальном 
подвести: подведём 
результат: результат 
год: году 
восток: восток 
добавить: добавим добавить 
крошечный: крошечные крошечный 
объяснять: объясняющих 
способ: способ способе способов 
математик: математика 
несмотря: несмотря 
рассказать: расскажу 
заниматься: занимается 
превратить: превратим 
туториал: туториал туториалов 
определить: определить определив 
кб: кб 
двигаться: движется 
графика: графики 
сайт: сайта сайт 
мой: мои моему 
стать: станет 
занять: занять 
повторять: повторять 
сработать: сработало 
экономить: экономит 
вниз: вниз 
идентичный: идентична 
задание: задания 
углубляться: углубляемся 
встречаться: встречаются 
оригинал: оригинале оригинала 
заново: заново 
оно: оно 
вычислять: вычислять вычисляя 
основание: основании 
показаться: покажется 
ровно: ровно 
оператор: оператора оператор 
прямой: прямыми прямые 
путь: путь пути 
переменный: переменных 
сообщать: сообщает сообщал 
игрок: игрока игрок игроком игроку 
данный: данном 
отрисовывать: отрисовывая отрисовывает отрисовывать 
верный: вернее 
создать: создать создадим 
железа: железе 
термин: термином термин 
глубина: глубины глубину 
просто: просто 
место: место 
канал: канал канала 
взаимодействие: взаимодействий взаимодействиях 
всё: всё 
установить: установив установить 
фича: фичу фичами 
игровой: игровую игровой игровая 
школа: школе 
быстрый: быстрее 
также: также 
компьютерный: компьютерном 
помещать: помещать 
работать: работают работаем работает работала 
который: который которое которой которые которая которого 
возвращать: возвращающий 
бхаскар: бхаскары 
менять: менять 
мы: нам нами 
обратить: обратите 
окружить: окружена 
отражать: отражает 
минималистичный: минималистичен 
вызывающий: вызывающий 
некоторый: некоторые 
определимый: определим 
калькулятор: калькуляторе 
достаточно: достаточно 
запустить: запустить 
сливаться: сливаются 
дисковый: дисковый 
байт: байта 
безопасный: безопасная безопасных 
смешивать: смешивает 
попробовать: попробовать попробуем 
подобный: подобное подобными 
константа: константу констант константы 
мина: мин 
подготовка: подготовка 
давать: давайте давать даёт 
смочь: сможете смог смогли сможем 
постоять: постойте 
суть: сути 
влево: влево 
линейный: линейной 
проект: проекта проект 
три: трёх 
разработчик: разработчик 
функция: функцию функция функциями функций функции 
располагаться: располагались 
увидеть: увидите увидим увидеть 
дублироваться: дублирующихся 
помогать: помогает 
предоставить: предоставит 
высота: высота высотой высотами высоты высоту высот 
добавление: добавление 
уместить: уместить 
язык: языке язык языком языка языков 
персонаж: персонажа 
объект: объекты 
геометрия: геометрии 
оставаться: остаётся 
два: двух две 
обойти: обойти 
разработка: разработка 
храниться: хранящегося 
репозиторий: репозиторий 
обзор: обзора 
клетка: клетку 
момент: момента момент 
придать: придадим 
перемещаться: перемещаться 
отрисовать: отрисовать 
изначально: изначально 
устроенный: устроен 
хороший: хороша лучшие хорошие 
пропустить: пропущу 
похожий: похожие 
пересекаться: пересекается пересекаются 
модификация: модификации 
предполагать: предполагает 
кадр: кадрами кадре 
сэкономить: сэкономлю 
неприемлемый: неприемлемо 
надеяться: надеюсь 
потребительский: потребительских 
единица: единице единицы единицу 
попытка: попытки 
аппаратный: аппаратного 
экономия: экономии 
способный: способны 
вид: вид виде 
изменить: изменить 
помощь: помощи 
мёртвый: мёртвого 
определение: определений 
основать: основан 
перемещать: перемещали перемещать 
диск: диске 
сначала: сначала 
назвать: назвать 
компилятор: компилятору компилятор 
устранение: устранения устранением 
выбрать: выбранной 
ответ: ответ 
хм: хм 
различать: различать 
большой: велика 
внимание: внимание 
внешний: внешней внешних 
добиться: добиться 
шум: шума 
консоль: консоли 
воспринимать: воспринимать 
подробность: подробности 
стрелка: стрелку стрелками 
любопытно: любопытно 
меню: меню 
глаз: глаза глаз 
размер: размер размера 
волшебный: волшебное 
отрицательный: отрицательны 
собственный: собственной 
ширина: шириной ширины ширина ширину 
делаться: делается 
уменьшать: уменьшаем 
однако: однако 
точно: точно 
частый: чаще 
изолировать: изолируем 
видно: видно 
интересно: интересно 
звук: звук 
формула: формулы формулу 
получать: получаем получать 
шутер: шутеров 
дзен: дзен 
многократно: многократно 
стена: стене стенам стенами стену стеной стен стены стена 
считать: считаете 
назначить: назначить 
устаревший: устаревшей 
точность: точность 
карма: карма 
различить: различить 
сетка: сетки сетке 
объектив: объектив 
небезопасный: небезопасный 
заключение: заключение 
ускорение: ускорения 
нравиться: нравится 
занятый: занята 
необходимо: необходимо 
профиль: профиль 
зависимость: зависимости 
пользовательский: пользовательский 
разумеется: разумеется 
маленький: меньше 
убедительный: убедительную 
дать: дам 
код: кода коде код 
чёткий: чёткую 
невозможно: невозможно 
угловой: угловое 
стандартный: стандартной стандартная 
сдвигать: сдвигает 
метафора: метафорой 
рабочий: рабочий 
разыменование: разыменование 
задача: задачу задачи 
прыгать: прыгать 
применять: применяют 
поддержка: поддержка 
бойлерплейт: бойлерплейта бойлерплейт 
зрительный: зрительная 
динамический: динамическую 
структура: структуру 
компьютер: компьютеров 
позволять: позволяет 
находить: находя 
разный: разному разные разными 
описание: описания описание 
ввести: ввести 
взять: взять взят 
выглядеть: выглядит выглядят 
вне: вне 
эмулировать: эмулировать 
незнакомый: незнакомых 
разобраться: разберёмся 
основной: основной 
практика: практике 
надоедать: надоедай 
происходить: происходит 
вызвать: вызвать вызвано вызвав 
переписать: переписать 
тег: теги 
перескочить: перескочить 
жёсткий: жёсткие 
впечатляющий: впечатляющие впечатляющий 
особенно: особенно 
легко: легко 
предоставлять: предоставляет предоставляемой 
обходить: обходить 
очень: очень 
чётко: чётко 
геймпадов: геймпадов 
разность: разность разности 
получить: получить 
раскрашивать: раскрашивая 
корректировка: корректировку 
ось: ось 
превью: превью 
назад: назад 
подробный: подробнее подробный 
хотя: хотя 
лицо: лица 
сверху: сверху 
понять: понять 
помочь: поможет 
недостаточно: недостаточно 
краткий: краткое 
центр: центра 
я: мной 
внутрь: внутрь 
наивный: наивное 
опыт: опыты 
накопитель: накопитель 
минимизировать: минимизировать 
клавиша: клавишами клавиши 
предшественник: предшественнику 
процесс: процесс 
краткость: краткости 
практически: практически 
удаться: удалось 
наверно: наверно 
бросание: бросания 
переместить: переместить 
экспериментальный: экспериментальную экспериментальный 
доступ: доступа доступ 
волна: волн 
интерактивный: интерактивная интерактивна 
википедия: википедии 
протягивать: протягивает 
мозг: мозга 
ячейка: ячейку ячейки ячеек 
насчёт: насчёт 
изменение: изменения 
больший: большей 
поначалу: поначалу 
ради: ради 
битовый: битовые 
случай: случаев случае 
последний: последний последнее 
немного: немного 
отличить: отличить 
попадать: попадающие 
технический: техническая 
самостоятельно: самостоятельно 
количество: количество количества 
пока: пока 
найти: найти 
читаемый: читаемыми 
преобразовать: преобразовать преобразует 
пункт: пункт 
каков: каков 
гораздо: гораздо 
геймпада: геймпада 
закладка: закладки 
слово: слово 
предсказуемый: предсказуемыми 
неизменный: неизменной 
этап: этап 
построчно: построчно 
переопределение: переопределения 
включить: включить 
специальный: специальных 
цель: цель 
они: ними 
единый: единую 
определённый: определённые 
оба: обоих 
разработать: разработан 
коррекция: коррекцию 
исходник: исходников 
пример: пример 
новый: новый 
конфигурация: конфигурации 
конкретный: конкретный 
запад: запад 
удивительно: удивительно 
модуль: модуль 
проблематично: проблематично 
являться: является 
знакомый: знакомым 
знаменитый: знаменитая 
удивительный: удивительным 
наверху: наверху 
тригонометрический: тригонометрические 
автор: автор 
псевдо: псевдо 
должный: должна должен 
факт: факте 
поведение: поведение поведением 
нечто: нечто 
раздел: разделе 
выполняться: выполняться 
нужно: нужно 
аспект: аспекты 
хранение: хранения хранение 
метод: метод 
вход: входа 
перевод: перевод 
приступать: приступать 
остановиться: остановиться остановится 
заодно: заодно 
лишь: лишь 
пересечься: пересечётся 
ядро: ядро 
гц: гц 
превращать: превращает 
синус: синуса 
совершенно: совершенно 
выпустить: выпущенная 
сырой: сырых 
полезный: полезным полезные 
картридж: картриджа 
паника: панике 
сожаление: сожалению 
палитра: палитре 
наблюдение: наблюдение 
пк: пк 
означать: означает 
официальный: официальный 
фрагмент: фрагмент 
умножить: умножить умноженных 
заголовок: заголовке 
старый: старую 
красивый: красивом 
предстоять: предстоит 
здание: здания 
применение: применение 
род: рода 
этаж: этажей 
отрисовываться: отрисовываться 
север: север 
изменять: изменяем 
замена: замены 
иллюзия: иллюзию 
учёт: учётом 
хранить: хранить 
треугольный: треугольных 
скорее: скорее 
хаба: хабы 
равномерный: равномерными 
продлевать: продлевая продлевать 
образ: образом 
нажать: нажмём 
именование: именования 
появиться: появится 
ещё: ещё 
смещение: смещение 
нужный: нужна нужных 
рендеринг: рендерингом 
отлично: отлично 
слишком: слишком 
обычно: обычно 
теория: теории 
прочтение: прочтение 
благодаря: благодаря 
длинный: длинным 
бит: бите 
произвольный: произвольной 
кора: кора 
счастие: счастью 
проверка: проверки 
импульсный: импульсных 
сообщить: сообщить 
каждый: каждого каждом каждый каждую 
индекс: индекса 
лётный: лётный 
кроме: кроме 
сконфигурировать: сконфигурировать 
исполняемый: исполняемый 
практический: практические 
затем: затем 
исходный: исходный 
индексировать: индексирует 
синтаксис: синтаксиса 
точнее: точнее 
гарантия: гарантии 
вправо: вправо 
минимальный: минимальную 
система: систему 
большинство: большинство 
вертикаль: вертикали 
шестнадцатеричный: шестнадцатеричной 
рекомендовать: рекомендую 
отдельный: отдельные 
снаружи: снаружи 
представить: представить 
изменяться: изменяющихся 
неважный: неважным 
импорт: импорта 
жизнь: жизни 
продлить: продлив 
вести: ведут 
интересный: интересным 
вступать: вступает 
обёртка: обёрток 
получение: получение 
привязка: привязка 
пустой: пустое 
перейти: перейдите 
литерал: литералов 
зайти: зайдите 
столкнуться: столкнётся 
компиляция: компиляции 
воссоздаваться: воссоздаётся 
любой: любые любой любом 
сказать: скажу сказать 
настолько: настолько 
математика: математики 
написание: написанию 
жёстко: жёстко 
скриншот: скриншот 
заключаться: заключается 
граница: границе 
поэтапный: поэтапный 
хабра: хабр 
увеличение: увеличения 
просмотреть: просмотрим 
проецирование: проецирования 
значит: значит 
компилироваться: компилируется 
звучать: звучит 
двоичный: двоичный 
пакет: пакет 
симулятор: симулятор 
намного: намного 
ключевой: ключевое 
гарантировать: гарантировать 
идеально: идеально 
воспользоваться: воспользуюсь 
блок: блок 
творчество: творчества 
трудно: трудно 
вектор: вектором 
аналогичный: аналогичный 
загадка: загадкой 
обновляться: обновляется 
целый: целых 
мнение: мнению 
