послать: послал пошли 
реклама: реклама рекламы 
повторить: повторить 
оказаться: оказаться 
репутация: репутация репутацию 
мочь: могут можем могла 
логика: логика 
скрипт: скрипта скрипт 
ваш: ваш ваши ваше 
письмо: письмом письма письмо 
задача: задачи задачу задачами 
степень: степени 
реализовать: реализовать реализовал 
выставляться: выставляется 
заголовок: заголовка заголовок заголовки 
фронтендер: фронтендер 
несложно: несложно 
флажок: флажков 
большой: большой 
понять: поняли понять 
поддерживать: поддерживать 
закруглённость: закругленности 
дырка: дырки 
менять: меняете меняет 
встречать: встречали 
гугл: гугл 
предел: пределы пределами 
содержимое: содержимому содержимым содержимого содержимое 
тег: тега теги 
маска: маска 
одинаковый: одинаковые 
поле: поле полям полей поля 
банковский: банковский 
действие: действия 
документ: документом документ документе документа 
атака: атаки атака 
устроенный: устроенные 
один: одного одну одна одной 
нетривиальный: нетривиально 
внимание: внимание 
яндекс: яндекс 
актуальный: актуальным 
спамит: спамит 
подгрузка: подгрузка 
отдельный: отдельную отдельное отдельный отдельному отдельная 
получиться: получится 
автоматически: автоматически 
значение: значение значения 
красиво: красиво 
успешно: успешно 
онтико: онтико 
заниматься: занимаюсь занимаемся 
режим: режиме 
классический: классическое 
регулярный: регулярный 
указывать: указывать 
вставить: вставить 
напрямую: напрямую 
платёжный: платежных 
брать: берём брали берет 
сам: самого самом самому самим само 
задумываться: задумываясь 
получать: получать 
сходить: сходить 
функция: функция функций 
загружаться: загружалось 
знать: знаете знал знали знать знает знаем 
строка: строке строку строк 
идти: шло идёт идут 
комментарий: комментарии 
голос: голосов 
раз: разу 
разработчик: разработчики разработчик разработчиков разработчика 
друг: другу друзья другом друг 
инженер: инженеры 
передавать: передает передаёт передаем передавать 
внешний: внешнему внешние 
случай: случай случае 
плохой: плохую 
написать: написал 
свой: своём свой своем свое своим своими 
страница: страницу странице страницы страница страницах 
прийти: пришло 
предотвращать: предотвращать 
меню: меню 
должный: должны должна должен должно 
сайт: сайту сайте сайты сайта сайт сайтов 
разработать: разработали 
сделать: сделает сделать сделал сделали 
маркетинг: маркетинг 
который: которыми которые которой которая который которому которое которого 
стиль: стиль стили 
привыкнуть: привыкли 
закешировать: закешировано закешировать 
конфетти: конфетти 
запрещать: запрещает 
иметь: имел имеет имеющий 
классный: классный классная классного 
висеть: висеть висит 
размер: размер 
левый: левый 
домен: домен домену доменах домене доменов доменом 
безопасность: безопасности безопасностью 
начинать: начинаете начинают 
конкретный: конкретным конкретного 
оставление: оставлением 
продавец: продавцы продавец 
правда: правда 
пинг: пинг 
именно: именно 
поведение: поведение 
помогать: помогать помогал помогают 
белый: белый 
часто: часто 
начать: начать начали начнёте начал начнёт 
дело: деле дело 
защита: защита 
шник: шников 
выбирать: выбираем 
взломать: взломаны 
нажимать: нажимает нажимаете нажимая 
ждать: ждёт ждать ждет 
помин: помине 
последовательно: последовательно 
слушать: слушаете слушать слушает 
добавить: добавить добавили 
сообщение: сообщение сообщением сообщениями сообщения 
правило: правила 
цвет: цвет 
лотерея: лотерею 
причём: причём 
открывать: открывающий открывает открывали открывать 
год: лет году года 
появиться: появился появилась 
современный: современном современная 
точно: точно 
вставлять: вставляет вставляете 
захотеть: захочет захотел 
адрес: адреса 
пронумеровать: пронумеровать 
флаг: флаги флагами флагов 
частый: чаще 
помощь: помощью помощь 
огромный: огромные огромный огромная 
доходить: доходит доходите 
виджет: виджет виджетов 
формочка: формочка 
рассмотреть: рассмотрим 
подпись: подписи 
нужно: нужно 
партнёр: партнёров партнёр партнёра партнёры партнер 
развитие: развитии 
проблема: проблему проблема проблем проблемы 
пример: примеру примера пример 
ловить: ловите ловим 
пользователь: пользователя пользователь пользователю 
кнопка: кнопка кнопки кнопку 
что: чему 
ранний: раньше 
равно: равно 
окно: окна окно окне 
вкладка: вкладками 
вернуть: вернуть 
простой: проще простой 
кук: куками куки 
настройка: настройках настройка настройки 
отправить: отправить 
забытый: забыт 
подход: подход подходе 
вид: виде 
язык: языка язык 
получаться: получается 
ответ: ответом 
находиться: находится находилось 
моментально: моментально 
схема: схема схеме 
дзен: дзен 
сила: сила 
полезный: полезный полезной 
возможность: возможность возможностях возможности 
обвязываться: обвязывались 
какой: какую какое каким какие каком 
каждый: каждому каждый каждая 
статья: статью статьи 
итог: итоге 
доверие: доверия 
авторизация: авторизации авторизацию 
состав: составу 
прозрачный: прозрачным 
прямо: прямо 
вкусный: вкусная 
корректно: корректно 
закрыть: закрыть 
возраст: возраст 
сервер: сервер 
забрать: забрать 
набирать: набирать набирал 
снизу: снизу 
четыре: четыре 
основный: основным 
переворот: перевороты 
голубой: голубой 
поиск: поиск поиска 
тот: те тех 
доверенный: доверенных доверенный 
путь: пути 
видимый: видимой 
привычка: привычки 
использовать: использовать использующая 
переходить: переходите переходим 
аудит: аудит 
подумать: подумает подумали 
читать: читает читаете читайте 
популярность: популярности популярность 
реализация: реализации 
карма: карма 
расположить: расположено расположенных 
диалапа: диалапе 
сессия: сессия сессию 
адресный: адресной адресную 
мера: мере 
событие: событий событие 
работа: работы работе 
рабочий: рабочее 
быть: будете буду 
данные: данным данных 
поставить: поставил поставить 
принцип: принцип 
совершенно: совершенно 
выполнять: выполняет 
наверное: наверное 
делиться: делиться 
марать: марать 
несколько: несколько несколькими 
далее: далее 
псевдоним: псевдоним 
страна: странах 
передаться: передалась 
заключение: заключение 
камень: камни 
следующий: следующую следующие следующим следующий 
карточный: карточные карточным карточных карточной 
браузер: браузеру браузерах браузера браузер браузеры браузере 
туннель: туннель 
закинуть: закинем 
отвечать: отвечает отвечаем 
сей: сих 
сожаление: сожалению 
айфон: айфона 
зайти: зайти 
блогер: блогеру блогера блогеры 
удобно: удобно 
профиль: профиль 
навигация: навигацией навигацию навигация 
тыква: тыква 
активировать: активировать 
давать: даёт давайте дает 
хотеть: хочет хотим хотели хотите 
дорабатываться: дорабатывались 
бизнес: бизнесу бизнес 
маленький: маленький 
правильно: правильно 
активация: активация 
популярный: популярна популярный 
конфиденциальный: конфиденциальной конфиденциальную конфиденциальная 
ситуация: ситуация ситуации ситуацию 
теряться: теряются 
разместить: разместили 
злоумышленник: злоумышленник злоумышленнику 
грустный: грустная 
мыший: мышью 
плохо: плохо 
открываться: открывается 
отправка: отправку 
авторизоваться: авторизуется авторизуйся авторизоваться 
подводный: подводные 
проверять: проверять 
начало: начала 
захват: захват 
лидом: лидом 
древний: древний древнее 
быстрый: быстрый 
сторона: стороне стороны 
самый: самый самым самое самые 
слабый: слабом 
лишний: лишней 
открыть: открыты открыли открыл открыть 
крупный: крупная 
такой: такую такое такого такая таких 
ссылка: ссылки 
ставить: ставит ставь 
код: кода 
весь: вся всеми 
стать: стал 
старый: старую старый 
незаменимый: незаменимым незаменим 
возможный: возможные 
невозможно: невозможно 
мир: мире 
хранить: храните 
этот: этому эта этих 
оплата: оплатами оплату оплаты 
решить: решили решить 
загрузиться: загрузился 
технология: технология технологию технологиях 
её: её 
слать: шлют слать 
выигрыш: выигрыш 
начаться: началось 
бунин: бунина 
разрешать: разрешает 
задуматься: задуматься 
услышать: услышат 
уголок: уголков 
нужный: нужному 
контент: контент контента 
писать: пишут 
посчитать: посчитать 
понг: понг 
это: это этим 
обманывать: обманывают 
ом: ом 
конструировать: конструировать 
запрос: запрос запросе запросов запросы 
заполнить: заполнено 
этап: этапе 
говорить: говорим говорит 
наш: нашу нашего наш нашей нашему наша 
новость: новости 
поддержка: поддержка поддержку 
получить: получил получить 
зрелищно: зрелищно 
классно: классно 
суперпредложение: суперпредложение 
понятный: понятное 
побыть: побуду 
дополнительный: дополнительной 
илона: илона 
угодный: угодно 
шникнуть: шник 
изолировать: изолирован 
рик: рик 
знание: знаний 
перезагружать: перезагружать 
прийтись: придётся 
показать: показать 
почему: почему 
тёмный: тёмная 
значок: значок 
множество: множество 
текущий: текущий 
подписывание: подписывания 
дочерний: дочерний дочернем 
независимо: независимо 
тема: тема тему 
открытый: открытую 
хаба: хабы 
способ: способ способами 
проводить: проводить 
собственный: собственному собственный 
атрибут: атрибут атрибута 
андрей: андрей 
приходиться: приходиться 
рассказать: расскажу 
человек: человека люди человеку человек 
отслеживание: отслеживание 
интернет: интернета интернет интернете 
запросить: запросил 
ввести: введёт 
ром: ром 
подобный: подобных 
образ: образом 
использование: использование 
звать: зовут 
выглядеть: выглядит выглядело выглядеть 
подписываться: подписывается 
определить: определить 
внутри: внутри 
время: времени время 
обратно: обратно 
будущее: будущее 
обязать: обязан 
алерот: алерты 
доверчивый: доверчивый 
специфичность: специфичность 
сетка: сетке сетку 
адвокат: адвокат адвокатом 
основной: основной 
хороший: хороший хорош лучшие хорошее 
единственный: единственный 
брендбук: брендбуку 
практика: практике 
умолчание: умолчанию 
использоваться: использовался используется 
ещё: ещё 
разрешить: разрешить разрешенный 
разрабатывать: разрабатываете 
выгружать: выгружали 
загружать: загружаете загружает загружать 
происходить: происходит происходило 
форма: формы форму форм форма 
проклинать: проклинать 
портал: портал порталы портала 
владелец: владельца владелец 
закешироваться: закешировалась 
спецификация: спецификацию 
конец: конца 
отлично: отлично 
раскрыться: раскрылась 
вызвать: вызвать 
слишком: слишком 
попытаться: попытается 
важный: важное важная 
становиться: становится 
небезопасно: небезопасно 
везде: везде 
независимый: независимый 
ниже: ниже 
совет: совет 
уровень: уровень уровней 
оказываться: оказывается 
мимо: мимо 
прочтение: прочтение 
делать: делай делать делаете делает делал делали 
например: например 
делаться: делалось 
м: м 
процесс: процессами 
оно: оно 
дерево: дерево дереве 
поэтому: поэтому 
неудобство: неудобства 
разный: разные разных 
история: история 
максимально: максимально 
компания: компании компания 
превратиться: превратиться 
жирный: жирные 
легко: легко 
первый: первый первую 
нарисовать: нарисовали 
контейнер: контейнер контейнере 
мероприятие: мероприятия 
вопрос: вопросы 
готовиться: готовиться 
доставлять: доставлять 
пройти: прошло прошла прошли 
платить: платите 
сервис: сервис 
система: системы 
очень: очень 
реагировать: реагировать 
откопать: откопал 
лайк: лайк 
вокруг: вокруг 
кстати: кстати 
родственный: родственно 
небольшой: небольшой 
родительский: родительском родительского родительский 
вылезать: вылезает вылезало 
робот: роботы 
бывать: бывает бывают 
итак: итак 
информация: информацией информацию информации информация 
строиться: строится 
подключать: подключает 
оттуда: оттуда 
пароль: пароль 
поддерживаться: поддерживались поддерживалось 
зона: зоны 
переслать: перешли 
чёрный: чёрный 
конверсия: конверсия 
олег: олега 
летний: летней 
авиабилет: авиабилетов 
деньга: деньги денег 
магазин: магазины магазин 
готовый: готовые 
тратить: тратит 
магия: магии 
появляться: появляется 
модно: модно 
некоторый: некоторых 
обычный: обычные 
указать: указать 
поисковый: поисковые 
доменный: доменных доменные 
выбрасывать: выбрасывать 
конференция: конференции 
просто: просто 
прямоугольник: прямоугольник 
фейсбук: фейсбук 
придумать: придумали 
статус: статус статусе 
среагировать: среагировать 
место: место местах 
канал: канал 
кнопочка: кнопочкой кнопочку кнопочка 
невидимый: невидимый 
автофокус: автофокус 
круто: круто 
важно: важно 
всё: всё 
богатый: богаты 
музыка: музыку 
прислать: пришли 
рендерита: рендерит 
пять: пять 
затем: затем 
версия: версию 
кто: кому 
считать: считают 
закрывать: закрывали 
хотя: хотя 
оборот: обороты 
применяться: применяется 
коммерческий: коммерческий 
тыкать: тыкает 
рекомендоваться: рекомендуется 
списание: списании 
третий: третьей 
чётко: четко 
назвать: назовем 
грязный: грязная 
пользоваться: пользоваться 
ненужный: ненужные 
также: также 
встроить: встроили 
цель: целях 
заполнять: заполнять 
нагрузка: нагрузкой 
работать: работают работает работаю работало 
грамотно: грамотно 
уникальный: уникальный 
встречаться: встречается 
хакерский: хакерские хакерская 
списать: списали 
однопиксельный: однопиксельный 
плюс: плюс 
мы: нам 
экран: экран 
обратить: обратите 
связать: связать 
индексировать: индексировали 
штука: штуку 
право: право 
библиотека: библиотеки 
молодой: молодая 
микрофронтенд: микрофронтенд 
параметр: параметры 
скоростной: скоростной 
справляться: справлялся 
учебный: учебных 
дизайн: дизайне 
достаточно: достаточно 
прямой: прямого 
практически: практически 
ответить: ответить 
ввод: ввода 
фильтровать: фильтровать 
взять: взяли 
вещь: вещь вещей 
сертифицироваться: сертифицироваться 
наверно: наверно 
она: неё 
взаимодействовать: взаимодействовать 
вчера: вчера 
готовить: готовить 
закрыться: закроемся 
пытаться: пытаемся 
эквайринг: эквайрингом 
фишинговый: фишинговый 
настроить: настроить 
кликать: кликая 
асинхронный: асинхронно 
вводить: вводит 
похоронить: похоронили 
утащить: утащить 
подгрузить: подгрузить 
попробовать: попробовать 
доступ: доступа доступ 
документация: документации 
стандартный: стандартная стандартное 
класс: классов 
растянуть: растянуть 
оба: оба 
мина: мин 
решение: решение 
веб: веб 
риск: риск 
ожидать: ожидали 
звёздочка: звёздочку 
формат: формата 
твиттер: твиттере твиттер 
устанавливаться: устанавливается 
аквариум: аквариуме 
подсказка: подсказки 
думать: думали 
сутки: сутки 
выиграть: выиграли 
свиток: свиток 
вылезти: вылезти 
сеть: сетей 
реализоваться: реализуется 
инициализация: инициализации 
вишня: вишня 
ребёнок: ребенка 
приходить: приходит 
лететь: летит 
некий: неким некое 
гитхаб: гитхаб 
залезть: залезть 
тэг: тэг 
состояние: состоянии 
новый: новых новый 
дизайнер: дизайнеры 
бэкенд: бэкенда 
безопасник: безопасниками 
немножко: немножко 
исключение: исключением 
слой: слоем 
выше: выше 
постоянно: постоянно 
защитить: защищён 
пустой: пустое 
заполнение: заполнения 
лепить: лепить 
особенность: особенностей 
вкусно: вкусно 
рука: руки 
рутинный: рутинных 
нумеровать: нумеровать 
туда: туда 
примерно: примерно 
поверх: поверх 
видеть: видит 
натянутый: натянут 
беспрепятственно: беспрепятственно 
вроде: вроде 
произойти: произойти 
рейтинг: рейтинг 
любой: любые любой 
другой: другие другую другое другому других 
лезть: лезете 
вконтакте: вконтакте 
оплатить: оплатить 
обойти: обойти 
спустя: спустя 
далёкий: дальше 
движение: движения 
сказать: скажу сказал сказать 
разработка: разработка 
выплёвывать: выплёвывает 
сложно: сложно 
уметь: уметь умеет 
технический: техническая 
подключить: подключи 
полностью: полностью 
небезопасный: небезопасное 
центр: центров 
биометрия: биометрию 
настолько: настолько 
обладать: обладает 
остальной: остальные 
общий: общий 
отдельно: отдельно 
количество: количество 
пока: пока 
называться: называется 
решать: решать 
защищаться: защищаться 
бэк: бэк 
хром: хроме 
слететь: слетела 
либо: либо 
заключаться: заключается 
вариант: вариантов вариант 
довольно: довольно 
наглядный: наглядный 
принимать: принимает принимать 
закладка: закладки 
уйти: ушли 
геморрой: геморроя 
инициал: инициалы 
др: др 
пора: пор 
карта: карт 
вёрстка: версткой 
похожий: похожие 
метрика: метрика 
доказывать: доказывать 
вернуться: вернуться 
безопасный: безопасен 
страничка: страничку 
многие: многие 
пробел: пробел 
подробно: подробно 
перевести: перевести 
смысл: смысл 
давность: давности 
счёт: счёт 
мортить: морти 
хабра: хабр 
сложность: сложности 
момент: момент 
выполнить: выполнить 
главное: главное 
сразу: сразу 
нативный: нативно 
блок: блоков 
сопутствовать: сопутствующими 
содержать: содержащий 
перекрёстный: перекрестное 
оставаться: остаются остаётся 
представимый: представим 
импотант: импотантами 
обновить: обновить 
название: название 
привести: приведу 
договориться: договориться 
задавать: задаёте 
включить: включить 
ум: ум 
дать: данные дать 
активный: активной 
заранее: заранее 
общение: общении общение 
значит: значит 
основа: основе 
догадываться: догадывается 
стоить: стоит 
просмотр: просмотров 
валидация: валидация 
публикация: публикации 
никакой: никаких 
заходить: заходите 
источник: источник 
цена: цена 
рендерим: рендерим 
становление: становления 
защититься: защититься 
узнать: узнать 
данный: данный 
короткий: короткий 
мало: мало 
кузнецов: кузнецов 
х: х 
загрузить: загрузить загрузили 
верхний: верхним 
намного: намного 
изнутри: изнутри 
взрыв: взрыв 
сложный: сложнее 
описание: описание 
развиваться: развиваться 
майкрософт: майкрософт 
вынести: вынести вынесешь 
гладко: гладко 
доверять: доверяете 
рунет: рунет 
наоборот: наоборот 
всплывать: всплывающие 
пиксель: пиксель 
номер: номер 
общаться: общаться 
вспомогательный: вспомогательный 
ограничение: ограничения ограничений 
всевозможный: всевозможными 
временами: временами 
рано: рано 
неизвестный: неизвестный 
блог: блог 
заря: заре 
смочь: смогут 
определённый: определенном 
быстро: быстро 
логин: логин 
социальный: социальных 
вывести: вывести 
рассказывать: рассказывать 
сложиться: сложилась 
пара: пару 
отвлекаться: отвлекаться 
вместе: вместе 
вообще: вообще 
сначала: сначала 
профессиональный: профессиональные 
кросс: кросс 
куча: куча 
замечание: замечание 
ограничивать: ограничивать 
