весь: весь всем 
метка: меткой меток меткам метками метки 
реальность: реальности 
го: го 
упрощать: упрощаем упрощай упрощать 
догадаться: догадался 
большой: большой 
пойти: пойдет 
коленка: коленке 
стартап: стартап стартапа 
рисовать: рисую 
грешить: грешу 
внимание: внимание 
проставлять: проставляю 
выбор: выбора выбор 
пользователь: пользователи пользователям пользователя пользователь пользователей 
яндекс: яндекс 
память: памяти 
заниматься: занимаюсь 
содержание: содержание 
напрямую: напрямую 
каждый: каждой каждый каждая 
разработать: разработал 
получать: получать 
привлечь: привлеченного 
комментарий: комментарии 
аналитик: аналитики аналитик 
продукт: продуктом продуктов продукт 
случай: случай случае 
упрощённый: упрощенным упрощенного упрощенный 
тема: темы 
меню: меню 
выборка: выборке 
потребность: потребность потребности 
удобный: удобнее удобного 
период: период 
далее: д далее 
копия: копиями 
часть: часть 
программист: программист 
изучать: изучай изучать 
мочь: мог 
правда: правда 
базовый: базовый 
защита: защита защитой 
речь: речь 
послесловие: послесловие 
сообщение: сообщений сообщения 
бот: ботов боту ботом 
добавить: добавить 
откуда: откуда 
группа: группой группу группе группа 
подзаголовок: подзаголовки 
виджет: виджет виджета 
кто: кого 
видно: видно 
такой: такие такое таком 
нужно: нужно 
подключение: подключения подключении 
считать: считать считай считал считаю 
превращаться: превращается 
отваливаться: отваливались отваливается 
подключить: подключенной подключенный подключить 
давать: давать даю 
никто: никто 
язык: языка язык 
требоваться: требуется 
идея: идея идеей 
находиться: находится 
дзен: дзен 
возможность: возможность 
реализация: реализация 
цветовой: цветовой 
итог: итоге 
посетитель: посетителя посетитель 
стоимость: стоимость 
собственно: собственно 
четыре: четыре 
поиск: поиск 
тот: те та той 
знать: знал знает 
карма: карма 
тип: типа типу 
оперативно: оперативно 
результат: результате результат результаты 
работа: работы работу работа 
управление: управления 
многое: многое 
неделя: неделю недели 
перестраховываться: перестраховывались 
путаться: путались 
убирать: убираем 
источник: источников источникам источником источники источниками 
написать: написать написан 
заключение: заключение 
терпимо: терпимо 
настройка: настройка настройки 
рука: руками 
необходимо: необходимо 
стать: статей стал стали 
удобно: удобно 
рассказать: рассказал расскажу 
профиль: профиль 
прочий: прочих 
визит: визита 
спам: спама 
маленький: меньше 
существование: существования 
переехать: переехал 
плохо: плохо 
мерка: меркам 
вводить: вводить 
простой: попроще простой 
уровень: уровне уровень 
начало: начала началу 
чат: чате чат чата чатом 
установка: установкой установку установки 
любить: люблю 
самый: самый 
регистрация: регистрациям регистрация регистрации 
ссылка: ссылки ссылкой 
старый: старую 
диаграмма: диаграмму 
предыдущий: предыдущей предыдущему 
использовать: используют 
выходной: выходные выходных 
посещаемость: посещаемость посещаемостью 
задумываться: задумывается 
личка: личку 
он: нему 
группировка: группировки группировкой 
подумать: подумать 
вытягивать: вытягиваю 
рабочий: рабочий 
красивый: красивые 
это: это этим 
начинать: начинать 
замечать: замечали 
первый: первого первая 
сторона: сторону 
продвижение: продвижению продвижения 
этап: этапе 
сайт: сайты сайта сайт сайтов 
поддержка: поддержка поддержкой 
который: которой которая 
понятный: понятное понятные понятный 
маркетинговый: маркетинговые маркетинговой 
видеть: видел 
почему: почему 
дать: данной данные 
хаба: хабы 
способ: способ способом 
должный: должен 
шайтан: шайтан 
появиться: появилась 
смысл: смысла 
скрипт: скриптом скрипт 
месяц: месяц месяца месяцев 
разбираться: разбираться 
минута: минут 
целевой: целевой 
забить: забил 
выглядеть: выглядит 
квест: квест 
просить: просят просили 
время: времени время 
выбирать: выбирали 
упрощение: упрощения 
хороший: хороший лучшие 
название: названия название 
умолчание: умолчанию 
стабильный: стабильнее 
показатель: показатели 
нужный: нужна нужен 
посещение: посещения 
последний: последнюю 
убрать: убрал 
страшный: страшного 
нерепрезентативный: нерепрезентативной 
проект: проект проекта проектом проектов 
слишком: слишком 
план: плане 
вечер: вечера 
начать: начал 
плохой: плохой плохим 
обычно: обычно 
тег: теги 
ждать: ждут 
прочтение: прочтение 
например: например 
вещь: вещах 
картинка: картинки 
сбор: сбора сбор 
поэтому: поэтому 
разный: разные 
максимально: максимально 
делать: делать 
компания: компании 
резервный: резервными 
технический: техническую техническая 
статья: статье статьях 
вначале: вначале 
сильно: сильно 
инструкция: инструкцию инструкции 
один: одна одно одной 
поздно: поздно 
очень: очень 
обычный: обычного 
группировать: группировать 
читать: читать 
кстати: кстати 
сложный: сложным 
помочь: помочь 
данный: данном 
минус: минус 
бывать: бывает 
учить: учи учить 
вывод: выводы 
действительно: действительно 
насколько: насколько 
готовый: готов 
конверсия: конверсия конверсии конверсию 
сколько: сколько 
пробовать: пробует 
следом: следом 
нерелевантный: нерелевантные 
появляться: появляется появляться 
создать: создать 
просто: просто 
воткнуть: воткнуть 
обратный: обратную 
устраивать: устраивает 
канал: канал канале канала 
нормально: нормально 
ситуация: ситуации 
смайлик: смайлики 
всё: всё 
назад: назад 
развитие: развитие 
версия: версию версии версия 
хотя: хотя 
анализировать: анализировать 
переполнение: переполнений 
понять: понять понял 
быстрый: быстрее быстрый 
общий: общем 
пользоваться: пользоваться 
точнее: точнее 
также: также 
писать: пишет 
команда: команду 
особый: особого 
показывать: показывать 
цена: цены 
сделать: сделано 
система: систему 
обратить: обратите 
кнопка: кнопкой 
история: истории 
я: мной 
некоторый: некоторые 
комментировать: комментировать 
создание: создание создания 
клиент: клиентов 
слышать: слышал 
практически: практически 
расширить: расширенный 
какой: каком 
пусть: пусть 
неактуальный: неактуальные 
полчаса: полчаса 
понимать: понимать 
разработка: разработке разработка 
привыкнуть: привык 
помощь: помощь 
мина: мин 
следующий: следующих следующей 
веб: веб 
тратить: тратила 
подсказка: подсказки 
работать: работает работал работающей 
всякий: всяких всякий 
сутки: сутки 
текущий: текущие текущего 
столько: столько 
новый: новых новый 
машина: машина 
удивляться: удивлялись 
разработчик: разработчик разработчика 
реклама: рекламы 
иначе: иначе 
любой: любых 
браться: берутся 
кейс: кейс 
концептуально: концептуально 
выше: выше 
данные: данных 
добавление: добавление 
детальный: детальнее 
реагировать: реагирую 
стабильно: стабильно 
отвечать: отвечать 
непонятный: непонятных 
пытаться: пытался 
рейтинг: рейтинг 
расти: растет 
составлять: составляет 
создаваться: создавался 
улучшать: улучшал 
возникать: возникала 
записываться: записывается 
бревно: бревно 
количество: количество 
прийти: пришел 
скриншот: скриншот 
пункт: пункту 
наглядный: наглядный 
буквально: буквально 
подстраивать: подстраивать 
закладка: закладки 
цифра: цифры 
статистика: статистики 
действие: действий действие 
похожий: похожие 
вернуться: вернуться 
возникновение: возникновения 
многие: многие 
привлечение: привлечения 
хабра: хабр 
код: код 
сложность: сложности 
момент: момент 
идти: шли 
обновить: обновить 
разобраться: разобраться 
соло: соло 
использоваться: используется 
два: две 
искать: искать 
заранее: заранее 
платить: платящего 
максимум: максимум 
просмотр: просмотров 
публикация: публикации 
поддерживать: поддерживала 
предупреждение: предупреждение 
вечером: вечером 
так: т 
говнюк: говнюков 
итоговый: итоговая 
оговорка: оговорка 
информация: информация 
серьёзный: серьезный 
связь: связь 
быть: будут 
метрика: метрики 
кампания: кампании 
запускать: запускает 
стучаться: стучались 
напомнить: напомню 
взлом: взломов 
занять: займет 
параллельно: параллельно 
пример: пример 
решить: решил 
обзавестись: обзавелся 
пара: пару 
вообще: вообще 
сначала: сначала 
аудитория: аудитории 
иконка: иконки 
петь: пет 
