мочь: могут можешь можете 
плохой: плохое 
поступок: поступков 
управление: управление 
ваш: ваш ваше вашего 
думать: думает 
напряжение: напряжении 
игра: игры 
покидать: покидает 
ребёнок: дети ребенок 
тиран: тираном тиран 
немедленный: немедленное 
подчинённый: подчиненных подчиненный 
свой: своего свои своих своем своей 
ответ: ответ ответа 
тиранический: тиранические 
ковыряться: ковыряться 
научиться: научиться 
диоген: диогена диоген 
являться: является 
область: области 
конфликтный: конфликтном конфликтный 
поле: поле 
длиться: длится длиться 
действие: действия действие 
поразительно: поразительно 
философ: философа 
один: одного одну одному одно одной 
счастливый: счастливым счастлив 
яндекс: яндекс 
здоровье: здоровье 
внешний: внешней внешние внешнюю 
поскольку: поскольку 
сосредоточить: сосредоточена 
нужный: нужны 
согласие: согласие 
дверь: дверь 
автоматически: автоматически 
влечение: влечений 
успешно: успешно 
исчерпать: исчерпают 
режим: режиме 
некоторый: некоторое 
состояние: состояний состояния состояние состоянии 
содержание: содержание 
борец: борец 
противник: противник 
шаг: шагом 
анализ: анализа 
ключевой: ключевым 
обмениваться: обмениваемся 
представлять: представляет 
комментарий: комментарии 
наверху: наверху 
голос: голосов голоса 
друг: другу другом друг 
издевательство: издевательства 
подавить: подавить 
подняться: поднимется подняться 
начинающий: начинающие 
отец: отец 
меню: меню 
выносить: выносить 
тот: тому тех ту 
любим: любим 
связанный: связанные 
целесообразно: целесообразно 
далее: д далее 
задача: задача 
понравиться: понравилась 
системный: системные 
часть: часть 
библиотека: библиотеку 
слышный: слышны 
сила: силу силы 
материальный: материальные 
продолжаться: продолжался 
правда: правда 
должный: должна должен 
берн: берном берна 
прошлый: прошлой 
хороший: лучшая хорошую лучшие хорошая 
покинуть: покинуть 
страх: страхом страхи 
поведение: поведение поведения 
возникать: возникать возникает возникающие 
переходить: переходит 
часто: часто 
добывать: добывает 
многий: многими 
дело: деле дело 
сказать: сказала скажите сказать 
послесловие: послесловие 
книга: книги книгу книга книге книг 
закончиться: закончатся 
начинать: начинает начинают 
добавить: добавить 
откуда: откуда 
очередь: очереди 
мышление: мышления мышление 
естественно: естественно 
концепция: концепцию концепции 
формально: формально 
навязать: навязали 
сам: самом сами самому сама 
частый: чаще 
вынудить: вынуждены вынужден 
такой: такие таким 
кто: кого кому 
нужно: нужно 
алиса: алиса алисы 
крайний: крайних 
аспект: аспекты 
элемент: элементом 
интересно: интересно 
находиться: находятся находится находитесь 
забота: заботы 
воспринять: воспринял 
жизнь: жизнь жизни 
смешной: смешного 
энергия: энергия энергию энергии 
случай: случаях 
иметь: имеют имело 
карман: карманах 
ранний: раньше 
обучать: обучают 
равно: равно 
родитель: родитель родителей родителя родителем 
недовольство: недовольство 
вова: вовы вова вове 
вернуть: вернуть вернёт 
тихий: тихие 
сделать: сделать 
невозмутимость: невозмутимость 
язык: языка язык 
который: которые которая который которую которое которого 
плач: плачем 
идея: идея идею 
метод: метод 
принятие: принятия 
спортсмен: спортсменов 
дзен: дзен 
конфликтовать: конфликтует конфликтующих 
гласить: гласит 
какой: какую какое каким каком 
вступать: вступают вступает 
падать: падает 
весы: весах 
поругать: поругали 
видимый: видимому 
амортизационный: амортизационный 
покупатель: покупатель 
угроза: угрозы 
продуктивный: продуктивного продуктивную продуктивно 
совесть: совесть 
первоисточник: первоисточник 
специально: специально 
пол: пола 
поиск: поиск 
высокий: высокую 
перекрещиваться: перекрещивающихся перекрещивающиеся перекрещивающимся 
специалист: специалистами 
желать: желаю 
использовать: использовать использовал используя 
отношение: отношения отношениях отношении 
стремиться: стремиться 
амортизация: амортизацию амортизации амортизация 
включение: включения 
шиза: шиза 
избегать: избегать 
карма: карма 
опекать: опекаемым опекает опекать 
тип: типа тип 
выныривать: выныриваем 
событие: событий 
работа: работы работу работе 
психология: психология психологии 
быть: будете е будем 
внимательно: внимательно 
соглашаться: соглашаемся соглашаться 
хотеть: хочешь хочет хотят хочу 
совершенно: совершенно 
принцип: принцип 
выполнять: выполняет 
второй: второй вторая 
умение: умением умение 
несколько: несколько 
место: месте место 
задаваться: задается 
деловой: деловые деловое деловой 
болезнь: болезнь болезни 
задний: задний 
серьёзный: серьезных 
жилище: жилище 
нравиться: нравится 
сцепиться: сцепился 
настройка: настройка 
решение: решений 
глава: глав 
отвечать: отвечает отвечают 
необходимо: необходимо 
желание: желаний 
следовательно: следовательно 
подзавести: подзавели 
обычный: обычных обычном 
взрослый: взрослых взрослом взрослого взрослой взрослый взрослую 
закон: закон 
карнеги: карнеги 
избежать: избежать 
навык: навыки 
профиль: профиль 
строить: строит 
стимул: стимулом стимула стимул 
коммуникативный: коммуникативный 
параллельный: параллельных параллельным параллельные 
давление: давление 
правильно: правильно 
разумеется: разумеется 
душа: души душе 
шить: шьет 
уступить: уступить 
зависеть: зависят зависеть 
феномен: феномены 
отвести: отвести 
фантазия: фантазия 
гневно: гневно 
благо: блага 
самый: самый самое 
тирания: тирания тирании 
сын: сына 
дитя: дитяти дитятей дитя 
весь: вся всем всей 
стать: стал стало стала стать 
разработать: разработанный 
старый: старую 
спонтанный: спонтанная 
опрометчивый: опрометчивых 
лишить: лишите 
активность: активность 
бой: боя 
выяснять: выясняет 
её: её 
увидеть: увидеть 
последовать: последовал 
пойти: пойдут 
токсичный: токсичный 
потерпеть: потерпеть 
каприз: капризы каприза 
убеждение: убеждения 
это: это этим 
материально: материально 
раб: рабе рабом раб 
выполнение: выполнение 
стереотип: стереотипу стереотипы 
обойтись: обойтись 
посмотреть: посмотрите 
первый: первого первая первый первую первым 
властвовать: властвовать 
сторона: сторону 
объявить: объяви 
нормальный: нормальные 
исключить: исключено 
внизу: внизу 
восемь: восемь 
пора: пора пор 
оттеснить: оттеснив 
свобода: свободе 
внутренний: внутреннем внутреннего 
психологический: психологическую психологический психологические психологическом психологического 
структура: структуре 
пища: пищу 
понятно: понятно 
служба: службе 
продажа: продажу 
поддержка: поддержка 
нетрудно: нетрудно 
непременно: непременно 
фехтование: фехтование 
играть: играют 
применимый: применимо 
спросить: спросить спросил 
потребность: потребностей 
дружный: дружный 
жить: живем живут 
опыт: опыт 
партнёр: партнеров партнеры партнера партнер 
почему: почему 
трансакция: трансакция трансакциям трансакциях трансакций трансакции 
камень: камень 
человек: людей человека людьми люди человек человеке 
защита: защиту 
платить: платят 
неравноправие: неравноправия 
дейл: дейл 
прекращаться: прекращается 
хаба: хабы 
броситься: бросился 
избежание: избежания 
продолжать: продолжать продолжаем 
становиться: становятся становится 
тирана: тиране 
рассказать: расскажу 
архитектурный: архитектурными 
минута: минут 
подавление: подавления 
образ: образом 
близкий: ближе 
прекрасный: прекрасного 
существующий: существующими 
пережевать: пережеванные 
уколоть: уколол 
пиджак: пиджак 
определить: определить 
знать: знать 
заступаться: заступается 
сомнение: сомнениях 
разрыв: разрыв разрывом 
бросить: брошен 
свободный: свободным 
пользователь: пользователь 
мелочь: мелочь 
прочтение: прочтению прочтение 
прямой: прямой 
стимулироваться: стимулируется 
ход: ход 
освобождать: освобождает 
развлекаться: развлекаемся 
толкать: толкает 
ученик: ученики 
протекать: протекают протекал 
работать: работающие работают работаем работать 
приходиться: приходится 
изменить: изменила 
необходимый: необходим необходимы 
производственный: производственных 
дальнейший: дальнейшие дальнейший 
уйти: уйти 
неуравновешенный: неуравновешенных 
консультирование: консультирования 
уточняться: уточняются 
последний: последнего последней последнее последним 
дать: дало дали данные дать 
начальник: начальника начальник начальнику 
среди: среди 
семейный: семейных 
обязанность: обязанность 
удерживаться: удерживаются 
течение: течение 
взять: взял взяли 
идти: идет идут идти 
р: р 
обычно: обычно 
бить: бьет 
следующий: следующим следующее 
направить: направлен 
конфликт: конфликт конфликта конфликтов конфликты 
нежелание: нежеланием 
тег: теги 
реплика: реплику 
вниз: вниз 
вернуться: вернемся вернуться 
уровень: уровень 
оказываться: оказывается 
опустить: опустить 
сидеть: сидит 
межличностный: межличностных 
доставлять: доставлял 
слушать: слушать 
натворить: натворил 
например: например 
парус: паруса 
м: м 
контролировать: контролирует 
прежде: прежде 
оно: оно 
физический: физическую физические 
поэтому: поэтому 
изменение: изменений 
рассчитать: рассчитать 
делать: делать делает 
софт: софт 
статья: статье статья 
коммуникация: коммуникации коммуникацию коммуникация 
направление: направлении направление 
вначале: вначале 
голова: голову 
прийти: прийти пришел 
вопрос: вопросами вопросы вопрос 
форма: форму 
обратный: обратном 
полезно: полезно 
эрик: эриком эрика 
путь: путь 
поздно: поздно 
очень: очень 
важный: важен важные 
включать: включает 
надоесть: надоест 
удар: ударов удары 
ефимович: ефимович 
сечь: сечет 
кроме: кроме 
негатив: негатива 
совещание: совещании 
итак: итак 
информация: информацией 
читатель: читатели 
мощный: мощный 
позиция: позиции позицию 
произнести: произнесла 
действительно: действительно 
обращаться: обращается 
сколько: сколько 
настроение: настроение 
произойти: произойдет 
глашатай: глашатая 
тиранить: тиранит 
самопомощь: самопомощи 
меч: меч 
появляться: появляется 
удерживать: удерживают 
рациональный: рациональное 
дитятя: дитятю 
овладеть: овладеть 
включить: включит 
просто: просто 
добавлять: добавляет 
одежда: одежду 
приём: приемом 
мяч: мяч 
ситуация: ситуации 
амортизировать: амортизирует амортизируем 
диалог: диалог 
рабство: рабство 
наш: наш наши нашей наших наша 
выполняться: выполняется 
назад: назад 
представляться: представляется 
трансакционный: трансакционного 
беспомощность: беспомощности 
затем: затем 
версия: версию 
считать: считают 
хотя: хотя 
проезд: проезда 
начинаться: начинается 
сплетничать: сплетничаем 
автобус: автобус 
михаил: михаил 
данный: данную 
интуиция: интуиция 
навигация: навигации 
чувствительный: чувствительным 
понять: понять 
вели: вели 
сокращение: сокращения 
выдержать: выдержит 
взаимоотношение: взаимоотношений 
также: также 
ясно: ясно 
автоматический: автоматическом автоматическим 
литвак: литвака 
развиваться: развивается 
подзарядить: подзарядило 
стиль: стиле 
проблема: проблемы 
придумать: придумал 
равноправие: равноправия 
определённый: определенного 
спрашивать: спрашивал 
выходной: выходной 
футболист: футболист 
тренировать: тренировать 
связь: связями 
такси: такси 
мозг: мозг 
этот: эта 
мы: нам 
история: истории 
погибнуть: погибли 
вести: ведет 
хохот: хохот 
прийтись: придется 
элементарный: элементарные 
улица: улицу 
успевать: успевают 
контакт: контакта 
средний: средний 
обучаться: обучаться 
мечтать: мечтает 
шесть: шесть 
оппонент: оппонент оппонента 
шторм: шторма 
сигнал: сигналам 
достаточно: достаточно 
карабкаться: карабкается 
закрыться: закрылась 
практически: практически 
лежать: лежит 
догадаться: догадаться 
неуверенный: неуверенный 
пропустить: пропустив 
подготовка: подготовку 
рекомендовать: рекомендую 
пусть: пусть 
уничтожение: уничтожения 
интимность: интимностью 
следовать: следует 
сочинять: сочинять 
дама: дама даме 
лекция: лекции 
простота: простоты 
посылать: посылает 
наступить: наступит 
арх: архи 
выведение: выведения 
выясняться: выясняются 
одновременно: одновременно 
потенциальный: потенциальный 
взаимопонимание: взаимопонимания 
выживание: выживания 
мой: мою 
попросить: попросил 
задавать: задаём 
куртка: куртка 
борьба: борьба 
забирать: забирает 
мина: мин 
состоять: состоит 
столкнуть: столкнули 
корабль: корабль 
личность: личности 
четверть: четверти 
взаимодействие: взаимодействия взаимодействием 
заглушить: заглушены 
сутки: сутки 
скандалить: скандалить 
переполненный: переполненный 
категорический: категорическое 
похожий: похожа похожие 
п: п 
столько: столько 
подождать: подождать 
единица: единицей 
давать: дает 
ссылаться: ссылается 
человеческий: человеческой человеческих 
раздаться: раздался 
неделя: неделе 
хозяин: хозяина 
ввести: введу 
скилла: скиллы 
выше: выше 
распоряжение: распоряжение 
предложение: предложения 
творчество: творчество 
постоянно: постоянно 
ступенька: ступеньку 
ради: ради 
проект: проектом 
вещь: вещи 
общение: общению общении общение общения 
повинный: повинную 
каждый: каждом 
получить: получит 
носить: носит 
рутинный: рутинных 
налезть: налезть 
инерция: инерции 
примерно: примерно 
пример: примере пример 
рассматривать: рассматривать 
тормоз: тормоза 
задействовать: задействованы 
разрядиться: разрядился 
движение: движение 
немного: немного 
производить: производит 
рейтинг: рейтинг 
обидчивый: обидчивое 
час: час 
другой: другие 
сотрудничество: сотрудничеству 
категорически: категорически 
ответить: ответил 
улучшить: улучшить 
лида: лиду 
продолжить: продолжат 
технический: техническая 
стоящий: стоящей 
немой: нем 
условие: условиях 
пальто: пальто 
выяснить: выяснить 
количество: количество 
пока: пока 
решать: решать 
собеседник: собеседника 
ветер: ветра 
многочисленный: многочисленных 
линия: линии 
упрёк: упреками упреки 
ладить: ладят 
принимать: принимает 
закладка: закладки 
пожалуй: пожалуй 
шаблон: шаблоны 
большой: большому 
прототип: прототипы 
классика: классикой 
впечатление: впечатление 
поездка: поездки 
возникновение: возникновения 
многие: многие 
запрограммировать: запрограммировать 
представить: представьте 
послать: послало 
жаловаться: жалуются 
себя: собой 
выражение: выражениях 
хабра: хабр 
попасть: попала 
код: код 
любой: любой 
сложность: сложности 
автопилот: автопилот 
долго: долго 
момент: момент 
сразу: сразу 
терпеть: терпеть 
наверх: наверх 
команда: команде 
удаваться: удается 
вновь: вновь 
кино: кино 
крик: криком 
обыденный: обыденных 
девиз: девизы 
руководитель: руководителем 
обновить: обновить 
мнение: мнения 
полиция: полиции 
партнёрша: партнерши 
привести: приведу привело 
возраст: возраста 
сохранить: сохранить 
деятельность: деятельность 
необходимость: необходимость 
основа: основы основе 
базар: базар 
дорогой: дорогие 
опека: опеки 
надеяться: надеюсь 
использоваться: используется 
время: время 
иссякнуть: иссякли 
выходить: выходят 
рабско: рабско 
искать: искать 
персонал: персоналом 
приобретать: приобретают 
заранее: заранее 
перестать: перестанут 
оставаться: оставаться 
цель: цель 
стоить: стоит 
просмотр: просмотров 
сообразить: сообразить 
провести: провести 
публикация: публикации 
традиционный: традиционный 
писать: писать 
источник: источник 
так: т 
последовательный: последовательных 
сохраняться: сохраняются 
поглаживание: поглаживания 
план: план 
серия: серию 
оплата: оплаты 
шлифоваться: шлифуются 
звучать: звучит 
мало: мало 
гора: горы 
счёт: счету 
некий: некое 
боксёр: боксер 
овладевать: овладевать 
словесный: словесное 
любознательность: любознательность 
квалификация: квалификацию 
брюки: брюки 
обязательно: обязательно 
восхищение: восхищения 
спокойствие: спокойствия 
пословица: пословица 
протиснуться: протиснулся 
радость: радость 
равный: равны 
психический: психическая 
фактически: фактически 
трансактный: трансактного 
получать: получаешь 
общаться: общаться общаются 
резюме: резюме 
довод: доводами 
слово: слова 
достигать: достигать 
механика: механику 
увлекать: увлекает 
возможный: возможным 
вода: воду 
психотерапия: психотерапии 
действовать: действуют 
рано: рано 
известно: известно 
скандал: скандал 
заниматься: заниматься 
представительница: представительниц 
основать: основан 
истощиться: истощится 
вывести: вывести 
профилактический: профилактическую 
уходить: уходит 
мужчина: мужчина 
купить: купить 
собираться: собирается 
мара: мар 
неудобство: неудобство 
вместе: вместе 
характер: характер 
вообще: вообще 
выставить: выставили 
обвинитель: обвинитель 
