подстановка: подстановки 
тый: тый 
оказаться: оказаться оказался оказалось окажется 
складываться: складываются 
мочь: могут можем могли можете 
конкретный: конкретный конкретное конкретном конкретного 
вероятность: вероятностью вероятностям вероятности вероятность вероятностей вероятностями 
задача: задачи задача задачах задачу 
распределение: распределению распределением распределение распределений распределении распределения распределениями распределениям 
день: дня дням дни день дней 
чтение: чтении чтению 
восходящий: восходящий восходящим восходящие 
различный: различных различный 
гармонический: гармоническому гармоническим гармонических гармонического гармоническими гармонические 
одинаковый: одинакова одинаковые одинаковую одинаковое одинаковыми одинакового одинаковым одинаковы 
распределить: распределён 
несложно: несложно 
вывод: вывод 
кругозор: кругозор 
переформулировать: переформулировать 
возрастать: возрастающие 
конечный: конечной 
коэффициент: коэффициентах коэффициентами коэффициентов коэффициенты коэффициентам коэффициент 
ответ: ответ ответа 
цвет: цветом 
скобка: скобках скобки 
система: системой 
влиять: влияет 
являться: является 
упростить: упростить 
зависимый: зависимо 
рекордсмен: рекордсменом 
перебор: перебора перебору 
друг: друга другу другом друг 
привести: привели привела приведены приведённый приведя приведённых 
знакомый: знакомое 
один: одного одну одним одном одному одной 
выбор: выбора выбор 
выполнение: выполнением выполнение выполнения 
яндекс: яндекс 
поскольку: поскольку 
получиться: получится 
сходиться: сходится 
обозначить: обозначу обозначены обозначен обозначив 
субботний: субботняя 
значение: значение значения значений значению 
доказать: доказать 
какой: какими каким 
ный: ный 
рассказать: рассказать 
срок: срока срок 
медленно: медленно 
вычислять: вычисляет 
задачка: задачка задачки 
определение: определением 
многоэтажный: многоэтажной 
стохастический: стохастической стохастические 
цепочка: цепочек цепочках цепочка цепочки 
шрифт: шрифтом 
компьютер: компьютеру компьютере 
каждый: каждой каждому каждого каждый каждая каждую 
ключевой: ключевым 
комбинаторика: комбинаторика комбинаторику комбинаторики комбинаторике 
функция: функция функции функциями функцией функцию функций 
добавление: добавления 
аппроксимация: аппроксимации 
комментарий: комментарии 
артур: артура 
удаться: удастся удалось 
голос: голосов 
очередной: очередной очередного 
перейти: перейти 
зелёный: зелёным 
хотеть: хотел хочет хотите хочу 
случай: случай случая случае случаю 
циклический: циклической циклических 
случайный: случайных случайной 
анимация: анимации 
жирный: жирным 
изложить: изложен 
количество: количества количеству количество 
меню: меню 
должный: должны должен 
тот: тому те тех 
уникальный: уникальные 
знаменитый: знаменитой 
описывать: описывает 
алгебра: алгебра алгебры 
загораживать: загораживают загораживает загораживающий загораживающие 
труд: труда 
факт: факту 
ряд: ряда 
рост: росту ростом рост роста 
наступление: наступления 
воспользоваться: воспользовался воспользоваться 
выражаться: выражающейся выражаясь выражается 
ограниченный: ограниченное 
оказываться: оказываться оказываются оказывались оказывается 
роберт: роберт 
конец: конце 
сила: силу 
перестановка: перестановкой перестановки перестановках перестановку перестановкам перестановке перестановок перестановка 
оставить: оставил 
определяться: определяются 
удивление: удивлением 
дедлайн: дедлайн дедлайном дедлайна 
именно: именно 
рекорд: рекорды рекордов рекорд рекордом 
выясниться: выяснилось 
часто: часто 
прибавить: прибавить 
знание: знанием 
рекордный: рекордной рекордных рекордные рекордными 
вид: виду виде вида вид 
максимальный: максимальную максимальной 
соотношение: соотношение соотношения 
такой: такими такие такого таком таким таких 
часть: частью 
мысль: мысль мысли 
выбрать: выбранный 
порядок: порядка порядке 
посвятить: посвящённой 
парень: парня 
свой: свой своё 
формула: формулу формуле формул 
имя: именем имени имя 
добавить: добавить добавим 
наводить: наводит 
впереди: впереди 
номер: номерами номером номер 
причём: причём 
очередь: очереди очередь очередей 
число: чисел числе числам числа числами числах числом числу число 
однако: однако 
год: лет 
точно: точно 
формально: формально 
зависеть: зависит 
любой: любой любую любыми любая любом 
обсуждать: обсуждаем 
считать: считая считать 
помощь: помощью 
произведение: произведения произведение 
видно: видно 
кто: кого 
нужно: нужно 
сюжет: сюжеты сюжет сюжетов 
элемент: элементом элемента элемент элементы элементов элементами 
жизнь: жизнь 
свойство: свойством свойства свойство 
штука: штук 
убывать: убывающими убывающую 
иметь: имеют имеющую имеет имея имеем иметь имею имеющих 
что: чему чём 
комментатор: комментаторов 
итого: итого 
нормальный: нормального 
равно: равно 
прямой: прямым 
поговорить: поговорим 
получать: получаем получая 
итерационный: итерационный 
придерживаться: придерживается придерживаясь 
получаться: получаются получается получающихся 
сделать: сделать сделаю 
язык: языка язык 
который: которые которой которая которых который которую которое котором которого 
класс: классы классах классов 
различимый: различимых 
произнести: произнёс 
различие: различия 
перебирать: перебирает 
некоторый: некоторую некоторого некоторых некоторый некоторому 
находиться: находится 
схема: схема 
самойленко: самойленко 
различаться: различающихся 
дзен: дзен 
многочлен: многочленов многочлена многочлены многочленах многочлен 
внешний: внешнего 
носитель: носитель носителя 
подсчёт: подсчёта 
ухо: уши 
высота: высоты высоте 
совпадение: совпадение 
сводиться: сводятся 
формализоваться: формализуется 
стирлинг: стирлинг стирлинга 
доказываться: доказывается 
нуль: нулю 
посмотреть: посмотрим 
сложить: сложив 
поиск: поиск 
путь: пути путь 
герой: героем 
композиция: композиции 
занятый: занято 
смотреть: см смотреть 
существовать: существует 
лишь: лишь 
график: график 
однозначно: однозначно 
вырожденный: вырожденным 
популярность: популярности 
работать: работавший работая 
определять: определяющем 
точный: точное 
применительно: применительно 
содержать: содержат содержит содержать 
шар: шары шару 
эквивалентный: эквивалентными 
карма: карма 
произвольно: произвольно 
хабра: хабре хабр 
дисперсия: дисперсия 
мера: мере 
результат: результате результат результата 
работа: работы работу 
популярный: популярной популярных 
исполнитель: исполнитель исполнителя 
век: века 
расти: растут 
подчиняться: подчиняющейся подчиняющихся подчиняется подчиняющиеся 
гармонично: гармонично 
равный: равную равна равное равны 
второй: второй второго 
иллюстрация: иллюстрации 
несколько: несколько 
последовательность: последовательности последовательность последовательностей 
указать: указанным 
называть: называть называют 
далее: далее 
длина: длину длин длина длиной длины длине 
принять: примем принято 
единственный: единственным единственный 
сегодня: сегодня 
настройка: настройка 
подчинённый: подчинённых 
обнаружить: обнаружить обнаружил 
округлить: округлён 
научно: научно 
часик: часик 
необходимо: необходимо 
два: двумя двух 
входить: входят входить 
аккуратно: аккуратно 
раскрыть: раскрыв 
измениться: изменится 
свёртка: свёртку свёртка свёртки свёрткой 
превышать: превышающих превышающими превышает превышающие 
вполне: вполне 
профиль: профиль 
программа: программу 
прочий: прочих 
перечислимый: перечислим 
стрелочка: стрелочками 
ранжирование: ранжирования ранжировании 
урна: урне урны 
выразить: выразить 
точка: точкой точку точек 
паблик: паблике 
преподаватель: преподаватель 
рассмотреть: рассмотренных рассмотренные 
беззнаковый: беззнаковых 
выражение: выражении выражение выражения 
вести: ведёт 
застройка: застройкой 
деление: деление 
разглядеть: разглядим разглядеть 
киношный: киношному 
остаться: осталось оставшихся 
называться: называются называется 
представлять: представляют 
основный: основное 
согласно: согласно 
порядковый: порядковый 
подставить: подставил 
произвольный: произвольного 
дискретный: дискретных дискретного 
делиться: делятся 
равномерный: равномерным 
стать: став стать 
старый: старую 
сеть: сети 
возможный: возможные возможный возможных возможны 
предыдущий: предыдущие предыдущих 
совпадать: совпадает 
тривиальный: тривиальных тривиальным тривиальный 
увеличить: увеличим 
суммирование: суммирования суммированием 
дробь: дробей 
переводить: переводя 
учитывать: учитывает 
её: её 
готовый: готова 
непересекающийся: непересекающихся 
эквивалентность: эквивалентности 
околоматематический: околоматематическом 
прогулка: прогулки прогулка 
род: рода 
чрезвычайно: чрезвычайно 
знать: знаю знать знаем 
встретить: встретить 
перемножить: перемножив 
моделирующий: моделирующая 
фигурировать: фигурируют 
задействовать: задействованные 
оператор: оператор 
ограничить: ограничен 
размышление: размышления 
величина: величина величины величиной величин 
говорить: говоря говорили говорят 
это: это этим 
умножить: умножив 
бернулли: бернулли 
заметить: заметить замечу 
первый: первого первый первой первым 
непрерывный: непрерывной непрерывным 
рассматривать: рассматривая рассматривал 
машина: машине 
сторона: сторону 
восемь: восемь 
неограниченно: неограниченно 
фиксировать: фиксированному 
похожий: похожее похожие 
производить: производящей производящими производящая производящих 
получить: получен полученной полученную получим получить полученными получили 
независимый: независимым независимыми 
житейский: житейской 
получение: получения 
крыться: кроется 
ожидать: ожидаемая ожидаемое 
поддержка: поддержка 
биномиальный: биномиальное биномиальной 
нетрудно: нетрудно 
выяснять: выяснял 
понятный: понятная 
положение: положения 
смело: смело 
пробовать: пробовать 
стоящий: стоящих 
распоряжение: распоряжении 
говориться: говорится 
линейно: линейно 
размещение: размещение 
встретиться: встретился встретятся 
прийтись: придётся 
показать: показать показана показан показало 
человек: людей людьми люди человек 
публикация: публикации 
ага: ага 
множество: множество 
беглый: беглые 
время: временем времени время 
верзила: верзила 
хаба: хабы 
способ: способ способы способов 
доставать: доставая 
математик: математика 
кружок: кружком 
появиться: появилась появится 
квадратный: квадратных 
регулярно: регулярно 
отражать: отражают 
похоже: похоже 
выделить: выделены 
образ: образом 
далёкий: далёким дальше 
выглядеть: выглядит 
классический: классический 
ярко: ярко 
ход: ход 
множитель: множитель 
сохранять: сохраняющее 
исключать: исключает 
дом: домов 
ещё: ещё 
обозначение: обозначение 
приходиться: приходится 
постановка: постановка 
вставить: вставив 
пятьдесят: пятьдесят 
индекс: индексов 
качество: качестве 
справочный: справочной 
рассказ: рассказа 
этап: этапа этапам этапов этап 
последний: последнего последний последним 
сумма: сумма суммами суммы сумме 
точность: точности 
соответствующий: соответствующими соответствующих 
среди: среди 
показывать: показывающей 
выдать: выдал 
следующий: следующим следующее следующего 
тег: теги 
соответствие: соответствие 
рекуррентный: рекуррентного рекуррентное рекуррентную рекуррентной 
теория: теории 
закон: законам 
ниже: ниже 
канонический: канонической 
уровень: уровень 
занимательный: занимательные 
прочтение: прочтение 
например: например 
встречаться: встречаются 
форма: форме 
шаров: шаров 
индуктивный: индуктивной индуктивно 
оно: оно 
набор: набором 
разный: разные 
никакой: никакого 
рассуждение: рассуждений рассуждениями рассуждения 
скажем: скажем 
мощность: мощность 
легко: легко 
статья: статье статья статьи 
ого: ого 
расположение: расположение 
комбинаторный: комбинаторная 
обратный: обратном 
ровно: ровно 
увлечься: увлёкшись 
стратегия: стратегии 
выполнять: выполнять 
полезно: полезно 
случиться: случиться 
высокий: высокие 
состоять: состоящую 
цикл: цикл циклами циклом циклы циклов циклам 
контекст: контексте контекст 
наш: нашего наш наши нашем наша 
любопытный: любопытная 
важный: важный 
кроме: кроме 
решать: решал 
подлость: подлости 
выстроиться: выстроились 
итак: итак 
третий: третий 
единица: единицу единица 
слева: слева 
приводить: приводит приводящих приводят 
действительно: действительно 
позиция: позиции 
перемножаться: перемножаются 
план: планы 
тым: тым 
широко: широко 
сколько: сколько 
наука: науке 
появляться: появляется 
создать: создать 
описать: описанной описаны 
отсутствие: отсутствия 
просто: просто 
направо: направо 
разнообразный: разнообразных 
пересчитать: пересчитав 
важно: важно 
всё: всё 
казаться: кажется 
назад: назад 
выполняться: выполняется 
пять: пять 
иметься: имеется 
версия: версию версии 
объединять: объединяет 
хотя: хотя 
условно: условно 
познакомиться: познакомиться 
распараллеливание: распараллеливания 
сверху: сверху 
известный: известных 
безалаберный: безалаберной безалаберного 
также: также 
нехитрый: нехитрая 
посередине: посередине 
равновероятный: равновероятны 
гистограмма: гистограммы гистограммами 
уменьшение: уменьшения 
устояться: устоявшегося 
начало: начале 
увидеть: увидим 
этот: эта этих 
мы: нам нами 
история: истории 
предельный: предельное предельного 
переписать: перепишем 
сравнение: сравнение 
средний: средний среднее 
составлять: составляем 
математический: математическое 
статистика: статистикой статистику статистики 
общий: общее 
редкий: редким 
линейность: линейности 
подразумеваться: подразумевается 
диаграмма: диаграммы 
частичный: частичной 
помнить: помним 
интуитивно: интуитивно 
дело: дела дело дел 
процесс: процесс процессов 
практически: практически 
затылок: затылок 
торчать: торчат 
вариант: варианты вариантов 
действовать: действовать 
бенджамин: бенджамина 
мой: моим 
хороший: лучшие 
рекомендовать: рекомендую 
вывести: вывели 
пусть: пусть 
факториал: факториалы факториала факториалом факториал 
объединить: объединённых 
она: неё 
вчера: вчера 
ожидание: ожидание 
всматривание: всматривания 
наступить: наступит 
полином: полиномов 
вопрос: вопрос 
место: местах 
войти: войти 
пристальный: пристального 
параметр: параметрами параметром 
метод: методом 
видимый: видимого видимых 
представить: представить 
строго: строго 
сотрудник: сотрудник 
мина: мин 
решение: решение решения 
выяснить: выясним 
десять: десять 
он: нём 
связанный: связанных 
нынешний: нынешнего 
давать: давайте 
пара: пара 
сутки: сутки 
сравнить: сравните 
загородить: загорожен 
переставить: переставить 
завершение: завершении 
самый: самая самое 
увеличиваться: увеличивается 
меняться: меняется 
три: трёх 
настоящий: настоящий 
связать: связаны связано 
исследовать: исследуемой 
всякий: всякую 
сергей: сергей 
неподвижный: неподвижную неподвижной 
убедиться: убедиться 
экспоненциальный: экспоненциального 
выше: выше 
входящий: входящих 
быть: будем будут 
рассуждать: рассуждать 
низкий: низких 
соответствовать: соответствует 
правый: правую 
схематично: схематично 
микрорайон: микрорайоне 
завершаться: завершается 
вычисляться: вычисляется 
разумный: разумным 
неизменный: неизменным 
туда: туда 
малый: малых 
операция: операция 
книга: книгой 
пример: примерах примера пример 
немного: немного 
искомый: искомую искомой 
демонстрация: демонстрация 
рейтинг: рейтинг 
соавтор: соавторами 
четыре: четырёх 
другой: другие другую 
округление: округлении 
успеть: успеете успеть 
реалистичный: реалистичной 
технический: техническая 
предполагаться: предполагается 
дать: дав 
текущий: текущим 
экспериментировать: экспериментировать 
позволить: позволю 
оценить: оценить 
остальной: остальные 
вводный: вводной 
гамма: гамма 
пока: пока 
свести: сведя свести 
доказательство: доказательства 
присмотреться: присмотримся 
найти: найти 
соображение: соображению 
поиграть: поиграть 
либо: либо 
гораздо: гораздо 
довольно: довольно 
закладка: закладки 
неспешно: неспешно 
программка: программка 
народ: народа 
пора: пор 
вооружиться: вооружившись 
натуральный: натуральных натуральное 
вероятностный: вероятностные 
научный: научный 
вернуться: вернуться 
превосходить: превосходит 
распределяться: распределяются 
подзадача: подзадач 
честно: честно 
подробно: подробно 
эффективно: эффективно 
ощущение: ощущение 
верно: верно 
философский: философские 
высокоэнтропийный: высокоэнтропийных 
таки: таки 
впервые: впервые 
поделить: поделив 
граничный: граничных 
сложность: сложности 
увеличение: увеличения 
момент: момент 
характеристика: характеристики 
сразу: сразу 
главное: главное 
выполнить: выполнить 
вновь: вновь 
забыть: забыть 
обновить: обновить 
пронумеровать: пронумерованных 
факторизовать: факторизовать 
предпоследний: предпоследний 
отличаться: отличающиеся 
возникать: возникающие 
игнорировать: игнорируя 
кой: коих 
значит: значит 
нарушать: нарушающих 
сочетание: сочетаний 
матожидание: матожиданий матожидание 
прищуриться: прищурившись 
просмотр: просмотров 
просчитать: просчитать 
серьёзный: серьёзные 
последовательный: последовательных 
неубедительно: неубедительно 
расширить: расширить 
наглядность: наглядности 
попытка: попытки 
ум: уме 
среднее: среднего 
ранжировать: ранжировать 
звезда: звёзд 
буква: буквами 
любить: любит 
связь: связь 
завести: завели 
отношение: отношение 
нарушить: нарушил 
отличие: отличие 
они: ними 
неожиданный: неожиданный 
сгорание: сгорания 
обязательно: обязательно 
индукция: индукцией 
поставить: поставить 
устойчивый: устойчивых 
вычислимый: вычислим 
разложение: разложении 
напомнить: напомню 
дополнительный: дополнительный 
численный: численного 
относиться: относится 
известно: известно 
быстро: быстро 
приглашать: приглашаю 
основной: основные 
бернуллиев: бернуллиевых 
вычислить: вычислить 
народонаселение: народонаселения 
минимум: минимумом 
новый: новый 
интересовать: интересует 
эксперимент: эксперимента 
руководитель: руководитель 
русскоязычный: русскоязычной 
складывать: складывая 
наполнить: наполнить 
заменимый: заменим 
дюжина: дюжины 
