адрес: адресов адреса адресами адресу адрес 
система: системе системой система системах системы систем 
порт: порт порта 
определяться: определяется 
управление: управление управления 
степень: степени 
структура: структура структуры структуре структуру 
модуль: модуль модули модуля модулей 
виртуальный: виртуальные виртуальный виртуального виртуальной виртуальная виртуальных виртуальную виртуальными 
сперва: сперва 
иметься: имеются 
различный: различных 
касаться: касаться 
свой: своего своих своей 
пожертвовать: пожертвовать 
вывод: вывод вывода 
архитектура: архитектур 
ответ: ответ 
поддерживать: поддерживать поддерживали поддерживающими поддерживаемых поддерживал поддерживающим 
машина: машиной машин машине машину машина машинами машины 
область: области областях 
являться: является являюсь 
использовать: используемой использовало использующий используют используемый используя 
шина: шина шины шиной шину 
путём: путем 
претендовать: претендую 
израильский: израильской 
аппаратный: аппаратных аппаратная аппаратную аппаратной 
поле: поле 
сборка: сборку 
фраза: фраз фразы 
записать: записать 
один: одного одним одно одной 
выполнение: выполнением выполнение выполнения выполнении 
яндекс: яндекс 
обработка: обработки обработка обработку 
внешний: внешней 
назначение: назначение 
получиться: получится 
значение: значение значения значениями значению значением 
сегментный: сегментных сегментный сегментная 
память: памяти память памятью 
рассказать: рассказать 
режим: режиме режима режимы режимами режим 
разработка: разработкой разработка 
реализовать: реализованы 
главное: главного главное 
указывать: указывать указывал 
напрямую: напрямую 
продолжить: продолжу 
второе: второе 
шаг: шагом 
войти: вошел 
каждый: каждой каждым каждом каждый каждая 
разобраться: разберемся разобраться 
представить: представлен 
выполняться: выполняются выполняется 
запуск: запуском запуск запуска 
осуществить: осуществить 
комментарий: комментарии комментариях 
год: год году года 
голос: голосов 
разработчик: разработчики разработчиков разработчиком 
специальный: специальное специальному специальные специальную 
перейти: перейти перейдем перейдет 
состояние: состояния 
передавать: передает 
абстракция: абстракцию 
объяснять: объяснял 
копирование: копирования 
считывать: считывает 
каков: какова 
меню: меню 
должный: должны должна 
посмотреть: посмотреть 
помимо: помимо 
функция: функции 
получить: получивший полученном полученный получить 
сдвигаться: сдвигался 
команда: командой команды команду команд 
связанный: связанные 
фиксировать: фиксированный фиксированному 
задача: задача 
регистр: регистре регистров регистры регистр 
судить: судя 
выйти: вышедшем вышедшие вышедших 
часть: часть частью части 
регион: регионов регион 
программист: программист 
автор: автором 
любой: любое 
сила: силу 
конец: конце конец 
размер: размер размере 
черта: чертах 
малый: малом 
именно: именно 
битный: битными битной битная битную битный 
отвечать: отвечающей 
взаимодействие: взаимодействие 
дескриптор: дескрипторе дескрипторов дескриптор 
базовый: базовый 
заморачиваться: заморачиваться 
октябрь: октябрь октябре 
часто: часто 
исключение: исключений 
нововведение: нововведением 
загружаться: загружается загружались 
выводить: выводим выводить 
живой: живых 
означать: означало означает 
коротко: коротко 
процессор: процессорами процессоры процессоре процессорах процессоров процессора процессор процессором 
эксперт: экспертом эксперта 
известный: известной известный 
нога: ног 
дистрибутив: дистрибутивах 
сообщение: сообщений сообщение сообщения 
добавить: добавить добавленные добавлена добавлен 
декабрь: декабрь декабрем декабре 
приводить: приводить приводила 
однако: однако 
записывать: записывает записываем 
естественно: естественно 
создавать: создаваемая создавать создает 
сам: самом самому само 
начинать: начинал начиная начинают 
трекинг: трекинг 
помощь: помощью 
начальный: начальное начальный 
исполнение: исполнение исполнения 
вызов: вызов вызова вызовы вызовов вызовом 
такой: такие такое такого 
нужно: нужно 
симлинк: симлинки 
интересно: интересно 
случай: случаях случаев случае 
иметь: имеют имели имела имеет 
останавливаться: останавливается 
таблица: таблиц таблицы 
трансляция: трансляции 
равно: равно 
среда: среда 
вид: виде 
выделять: выделяем 
новый: новую новые новых новое новый новой 
сделать: сделать сделаем 
доступный: доступным доступной 
чересчур: чересчур 
бесполезный: бесполезный 
принять: принят 
получаться: получается получался 
этот: этими этому этих 
который: которые которой которая которых который которому которое котором которого 
поправить: поправят 
скрытый: скрытые скрытая 
язык: языка язык 
требовать: требует требующих требовал 
находиться: находится 
защитить: защищенный защищенного защищенном 
выполнять: выполняемой выполняет 
приобретение: приобретения 
дзен: дзен 
вход: входа 
статья: статью статье статьи 
итог: итоге 
перевод: перевод 
ветка: ветку 
поздний: позже 
возврат: возврат 
остановиться: остановиться 
развитие: развития 
миграция: миграций 
первый: первые первого первое первый первых первую первой первым первыми 
собственно: собственно 
загрузка: загрузки 
гипервизора: гипервизора 
поиск: поиск 
зрение: зрения 
тот: те 
заимствовать: заимствованы 
приступить: приступим 
системный: системное системных 
существовать: существует 
лишь: лишь 
отношение: отношения 
динамически: динамически 
включение: включения включением 
опция: опции 
изменение: изменении изменений изменения 
карма: карма 
ядро: ядро ядра ядре 
запускать: запускающий запускать 
дата: дата 
деталь: деталями 
тип: типа 
дополнительный: дополнительных дополнительной дополнительные 
работа: работы работу работа работе 
приложение: приложений 
монитор: мониторе монитора 
главный: главную главная главным 
анекдот: анекдот 
генерация: генерации 
ситуация: ситуациях ситуация 
несколько: несколько 
остаться: оставшиеся осталось 
далее: далее 
написать: написать написаны 
соответствие: соответствия 
разобрать: разобрали разберем 
заключение: заключение 
отключить: отключить 
настройка: настройка 
сей: сих 
указатель: указателем 
открывать: открывал 
попытаться: попытаемся попытается попытаюсь 
отображать: отображает 
входить: входил входили 
обработчик: обработчиков 
профиль: профиль 
программа: программу программе программы 
исходник: исходники 
зависимость: зависимости 
консоль: консоль 
быть: буду будем будут 
пользовательский: пользовательский 
ассемблерный: ассемблерный 
сохраняться: сохранялись сохраняются 
виртуализация: виртуализация виртуализации 
появление: появления появлением появление 
отдельный: отдельный 
программный: программное программный 
мешать: мешает 
кодовый: кодового 
прерывание: прерывания прерываний 
выложить: выложены 
ошибка: ошибки ошибок 
пространство: пространства 
протокол: протокол 
нужный: нужное нужному нужные нужными 
смотреть: смотреть 
сложение: сложением 
мочь: можем могли 
проверять: проверять проверяют 
специфический: специфических 
образ: образ 
объяснение: объяснении 
флаг: флаг 
самый: самый самое 
около: ок 
эмулировать: эмулируем эмулировать 
регистрировать: регистрирует регистрировал 
драйвер: драйвер драйвера 
познакомиться: познакомившись 
инструкция: инструкция инструкцией инструкции инструкциями инструкций 
код: кода код коде 
стать: стал стало 
весь: вся всему 
сдвиг: сдвига 
детально: детально 
старый: старую 
скорректировать: скорректировать 
гостевой: гостевые гостевой гостевых 
покупка: покупке 
называть: называемый называют 
заработать: заработало 
общий: общих общем 
активировать: активировал активирует 
хостовый: хостовая хостовой 
битов: битов 
название: названием 
установить: установим 
битый: бита 
технология: технология технологией технологию 
начаться: началось начнется 
сторона: стороны 
инженер: инженер 
возможность: возможностей 
встретить: встретить 
условие: условия 
показать: покажу показать 
логирование: логирование 
думать: думаю 
это: это этим 
устройство: устройство устройства 
отправляться: отправляется 
страница: страницы страниц 
привилегированный: привилегированные привилегированным 
стек: стека 
этап: этапе 
поддержка: поддержка поддержкой поддержку поддержки 
изложение: изложения 
старт: старте старта 
сохранение: сохранения 
переводить: переводит 
текущий: текущей текущий текущая 
сегмент: сегмента сегмент сегментов 
остановка: остановкой 
адресовать: адресовать 
изобразить: изобразить 
патч: патча 
множество: множество 
регистрация: регистрацию 
скорее: скорее 
дать: данной данные 
шар: шар 
создаваться: создается 
очередь: очередь 
потребоваться: потребуется 
прекращаться: прекращается 
краткость: краткостью 
хаба: хабы 
математик: математика 
модель: модель 
приходиться: приходилось 
посвятить: посвященной 
соответствовать: соответствующая 
появиться: появилась появились 
месяц: месяц месяцев 
сотрудничать: сотрудничал 
выглядеть: выглядит 
тп: тп 
внутри: внутри 
определить: определить 
читаемый: читаем 
говорить: говорил 
обратно: обратно 
пользователь: пользователь 
добавлять: добавляющие добавляла 
вплоть: вплоть 
список: список 
ввести: введенного 
совместимость: совместимости 
физический: физическими физическую физический физической физическому физические 
основный: основная 
умолчание: умолчанию 
середина: середине 
использоваться: использовался использовалась использовавшимся используются используется 
смещение: смещение смещению смещения 
обращение: обращение 
процедура: процедура 
происходить: происходит происходило 
утомлять: утомлять 
мегабайт: мегабайта 
проект: проект 
замедлять: замедляло 
располагаться: располагалась располагаться располагался 
выставляться: выставлялся 
качество: качестве 
переход: переход 
большинство: большинстве 
возникновение: возникновении 
хотеть: хотим 
дебаг: дебаг 
объявить: объявила объявлен 
следующий: следующим следующий следующих следующей 
тег: теги 
обратный: обратной 
находить: находит 
копироваться: копируются копироваться копируется 
указываться: указывался указывается 
вернуться: вернемся вернуться 
уровень: уровень 
прочтение: прочтение 
например: например 
вычисляться: вычислялся вычисляется 
исполнять: исполнять 
поэтому: поэтому 
произвести: произведены произвести 
история: история истории историей историю 
компания: компании компания 
никакой: никакого никаких 
коммуникация: коммуникации 
файловый: файловом 
расширение: расширение расширений 
ускоритель: ускорителя 
непосредственно: непосредственно 
страничный: страничной 
сильно: сильно 
автоматический: автоматический 
выделить: выделенную 
байт: байт 
пройти: прошло 
начинаться: начиналось начинается 
состоять: состояла состоял состоит 
определять: определяет 
включаться: включается 
очень: очень 
синхронизировать: синхронизировать 
читать: читать 
включать: включает 
данные: данными данных 
цикл: цикл цикле 
процесс: процессу процессом процесс процесса 
эмулятор: эмулятор эмулятора 
подытожить: подытожить 
разный: разных 
вопрос: вопроса вопрос 
чтение: чтение чтения 
напоминать: напоминает 
явно: явно 
браться: брался 
разделять: разделяемая 
датироваться: датируются 
роль: роль 
воздушный: воздушный 
произойти: произойдет 
переключение: переключений переключении переключения 
механизм: механизм 
прочитать: прочитать прочитанный 
некоторый: некоторых некоторые 
исполняемый: исполняемый 
создать: создать создадим 
выход: выхода выход 
просто: просто 
состав: состав 
простой: простого простой 
назад: назад 
казаться: кажется 
представляться: представляется 
декодер: декодер 
версия: версию версии версия 
февраль: февраль 
затем: затем 
проверка: проверкой проверка 
абсолютно: абсолютно 
разрабатывать: разрабатывая 
вместо: вместо 
реальный: реальном реальный реального 
опубликовать: опубликованный 
применяться: применяется 
наш: нашей нашем 
ничто: ничто 
понять: понять 
упоминать: упоминал 
заниматься: занималась 
также: также 
писать: пишет 
порог: порога 
отображаться: отображаться 
менее: менее 
зато: зато 
анахронизм: анахронизм 
определённый: определенного 
практический: практическом 
грязный: грязные грязных 
начало: начале 
увидеть: увидим 
файл: файла файл 
открытый: открытый 
мы: нам 
создание: создании 
прошествие: прошествии 
прийтись: придется 
заполнить: заполнить заполнит 
скомпилировать: скомпилировать 
реально: реально 
оставаться: остается 
средний: средний 
теневой: теневые теневых 
тема: темах тему теме 
стабилизироваться: стабилизировался 
перенести: перенесены 
точка: точка точки 
документация: документацию 
верный: верный 
достаточно: достаточно 
прямой: прямого 
последний: последние 
ответить: ответить 
практически: практически 
управлять: управлять 
короче: короче 
какой: какие 
ввод: ввода 
изначальный: изначальном изначальный 
хороший: лучшие 
внутренний: внутреннего 
получать: получает 
лёт: лету 
анонимный: анонимный 
устаревший: устаревшим 
запустить: запустить запущенный 
ранее: ранее 
загружать: загружаемого загружаемых 
символьный: символьное 
они: ими 
привилегия: привилегий 
ноябрь: ноябре ноябрь 
информация: информацию информации 
сбивать: сбивает 
годиться: годятся 
доступ: доступа доступ 
сотрудник: сотрудник 
мина: мин 
решение: решение решения 
семейство: семейства 
начать: начнем 
текст: текст 
достижение: достижения 
операция: операций операции 
включить: включенной 
давать: давайте 
выделение: выделению выделении 
работать: работает работать 
суть: сути 
сутки: сутки 
меняться: меняется 
инициализация: инициализации 
обычный: обычным 
загрузиться: загрузиться 
равный: равен равное 
сброс: сброса 
знакомый: знакомого 
вакансия: вакансии вакансий 
стартовать: стартует 
запись: записи 
убедиться: убедиться 
выше: выше 
адресный: адресного 
центр: центрах 
релиз: релиз релиза 
удалённый: удаленного 
добавление: добавление 
огромный: огромному 
взять: возьмет 
туда: туда 
пример: примере примера 
доступно: доступно 
сюда: сюда 
краткий: краткая 
немного: немного 
производить: производит 
отобразить: отобразить 
вроде: вроде 
рейтинг: рейтинг 
разрабатываться: разрабатывался 
тяжёлый: тяжелый 
возобновляться: возобновляется 
экспортировать: экспортируемые 
настраивать: настраиваем настраивает 
два: двух 
спустя: спустя 
сказать: скажу 
рассылка: рассылке 
технический: техническая 
немой: нем 
отдельно: отдельно 
количество: количество 
аналогичный: аналогична аналогичная 
пока: пока 
продолжаться: продолжается 
полный: полный 
дело: делом 
называться: называется 
найти: найти 
упоминание: упоминание 
запуститься: запустится 
требоваться: требовалось 
заблокировать: заблокирована 
изначально: изначально 
пожалуй: пожалуй 
закладка: закладки 
программирование: программирование 
число: числу 
пора: пор 
расположить: расположить 
действие: действий 
выполнить: выполнит выполнить 
похожий: похожие 
удачно: удачно 
дизассемблировать: дизассемблировать 
поддерживаться: поддерживаются 
причина: причина причину 
хабра: хабр 
впервые: впервые 
сложность: сложности 
сразу: сразу 
момент: момент 
форк: форк 
позволять: позволяющего 
толк: толку 
различие: различие 
час: часа 
дальнейший: дальнейшее 
выступать: выступать 
оборудование: оборудования 
обновить: обновить 
привести: приведу 
центральный: центрального 
бесконечный: бесконечный 
надеяться: надеюсь 
время: время 
стартап: стартапа 
кто: кем 
изучение: изучению 
вложить: вложенных 
чувствовать: чувствует 
открыть: открыть 
основа: основе 
стоить: стоит 
просмотр: просмотров 
публикация: публикации 
груз: груз 
ход: ходу 
публиковать: публикует 
соответствующий: соответствующих 
архитектурный: архитектурно 
узнать: узнать 
попытка: попытки попытке 
набор: набор 
данный: данный 
непрерывный: непрерывных 
мало: мало 
неполный: неполный 
х: х 
открытие: открытием 
запускаться: запускаются запускается 
добавляться: добавлялась 
упрощённый: упрощенная 
тесно: тесно 
обёртка: обертки 
оба: обоих 
счёт: счет 
диск: диска 
блочный: блочного 
интеграция: интеграции 
напомнить: напомню 
складываться: складывался 
ошибиться: ошибся 
определение: определений 
попробовать: попробуем 
абстрактный: абстрактны 
быстро: быстро 
основной: основные 
возвращать: возвращает 
эмуляция: эмуляции 
вывести: вывести 
небольшой: небольшим 
постараться: постараюсь 
отправлять: отправлял 
решить: решил 
активно: активно 
вообще: вообще 
видеть: видим 
коммит: коммиты 
производиться: производится 
